EnigmaT Set Rips { Cuts } ΓÇô March 29th, 2013

After Effect - Amplitude (Wellenrausch Remix) (GDJB Rip)-enTc.mp3
Alexander Bergheau - Ca-Mind (ASOT 606 Rip)-enTc.mp3
Andrew Lang - Tomahawk (GDJB Rip)-enTc.mp3
Artra & Holland - Loadstar (Original Mix) (Cut From Nadz Set)-enTc.mp3
Chicane & Ferry Corsten feat. Christian Burns - One Thousand Suns (Soundprank Vocal Remix) (ASOT 606 Rip)-enTc.mp3
Chris Porter - The Sky At Night (ASOT 606 Rip)-enTc.mp3
Colldier - Until The Stars (Avi Remix) (Cut From Anderson Set)-enTc.mp3
Conjure One feat. Leigh Nash - Under the Gun (Rank 1 Remix) (ASOT 606 Rip)-enTc.mp3
Corderoy - Elextrix (ASOT 606 Rip)-enTc.mp3
Dallonte - New Vibe (Original Mix) (Cut From Anderson Set)-enTc.mp3
Dihan - Magic (French Skies Remix) (Cut From El-Jay Set)-enTc.mp3
Estiva - Teddybeat (-Short- ASOT 600 Rip)-enTc.mp3
Festen - Fuck the Bullshit (GDJB Rip)-enTc.mp3
Gal Abutbul feat. Phillipa Joy - Don't Mind Waiting (Dub Mix) (GDJB Rip)-enTc.mp3
Hadrianicus - The Battle Of Abydonia (Tech Mix) (Cut From El-Jay Set)-enTc.mp3
Heatbeat - Boom (ASOT 606 Rip)-enTc.mp3
Karybde & Scylla - Rock It! (Brian Flinn Remix) (Cut From Nadz Set)-enTc.mp3
Kevin B - Moon Rover (Original Mix) (Cut From El-Jay Set)-enTc.mp3
Lee Osborne - Milgauss (Crimson Remix) (Cut From Anderson Set)-enTc.mp3
Mark Sixma with W&W - Requiem (ASOT 606 Rip)-enTc.mp3
Mars Needs Lovers & Mmadcatz - Lovethief (Moonbeam Remix) (GDJB Rip)-enTc.mp3
Michael Hokanson - Allusion (Original Mix) (Cut From Anderson Set)-enTc.mp3
Miroslav Vrlik - Delight (Original Mix) (Cut From Anderson Set)-enTc.mp3
Miroslav Vrlik - November (Witness45 Remix) (Cut From Anderson Set)-enTc.mp3
Morttagua & Peter-A - Lifestream (Original Mix) (Cut From Anderson Set)-enTc.mp3
Oberon - Everything and More (Saga Remix) (Cut From El-Jay Set)-enTc.mp3
Philippe El Sisi - Darkness Falls (Melodic Mix) (Cut From Nadz Set)-enTc.mp3
Photographer - Tic Tac (Original Mix) (Cut From Nadz Set)-enTc.mp3
Sebastian Bronk - U R My Everything (Dub Mix) (GDJB Rip)-enTc.mp3
Shaun Greggan - Unconquered (Ian Standerwick Remix) (Cut From Nadz Set)-enTc.mp3
Terry Da Libra - Don't Give Up (ASOT 606 Rip)-enTc.mp3
The Archies - In Time (Original Mix) (Cut From Anderson Set)-enTc.mp3
Trance Arts & Colin James - Ballistic (Liam Wilson Remix) (Cut From Wilson Set)-enTc.mp3
Yodis - Inner World (GDJB Rip)-enTc.mp3
