After Meridian - Another Day (Holbrook & SkyKeeper Alternative Dub Mix) (Cut From Poshout Set)-enTc.mp3
AK9 & Tyler Hunt feat. Bombs and Bottles - Shadow (Cut From Emery Set)-enTc.mp3
Alan Crown - Freiheit (Original Mix) (Cut From Pobsky Set)-enTc.mp3
Alex M.I.F. - Ocean of Memories (Chris Casper Remix) (Cut From Above Clouds Set)-enTc.mp3
Alex Sonata feat. Quillia - Alive (Cut From Emery Set)-enTc.mp3
Alter Future - The Blind Side (Cut From Terry Set)-enTc.mp3
Aly & Fila feat. Chris Jones - Running Out Of Time (Uplifting Mix) (Cut From A&F Set)-enTc.mp3
Aly & Fila feat. Chris Jones - Running Out Of Time (Uplifting Mix) (Cut From GO Set)-enTc.mp3
Amin Keyhan - Zonnestraal (Mosahar Remix) (Cut 2 From Saux Set)-enTc.mp3
Amin Keyhan - Zonnestraal (Mosahar Remix) (Cut From Saux Set)-enTc.mp3
Ancient Mind - Scruffy (Original Mix) (Cut From tranzLift Set)-enTc.mp3
Andrew Bayer - Counting Down (ABGT 023 Rip) (┬½ΓÇó┬╗)-enTc.mp3
Andy Elliass Vs. Laucco - Flying With Angels (Original Mix) (Cut From tranzLift Set)-enTc.mp3
Andy Moor & Betsie Larkin - Love Again (LTN Remix) (Cut From Faruk Set)-enTc.mp3
Ane Burns - Let Myself Go (Nicone & Sascha Braemer Remix) (Cut From Aris Set)-enTc.mp3
Angry Man - Mescaline (Future Disciple Remix) (Cut From Photographer Set)-enTc.mp3
Argy Feat. Bajka - Upon Ourselves (Onsulade Stripped Mix) (Cut From Aris Set)-enTc.mp3
Ashley Wallbridge feat. Audrey Gallagher - Bang The Drum (Craig Connelly Remix)  (ASOT 600 Rip)-enTc.mp3
Atlantis Ocean - Nihil (Cut From Nickson Set)-enTc.mp3
Audiko - Vision (State4 Remix) (Cut From Anna Lee Set)-enTc.mp3
Awyat - Status Quo (Original Mix) (Cut From Gomrass Set)-enTc.mp3
Azima - Godsfalling (Original Mix) (Cut From Suzy Set)-enTc.mp3
Ben Summers - Mi Diosa (Praveen Achary Remix) (Cut From Config Set)-enTc.mp3
Billy Gillies - Daytona (Original Mix) (Cut From GO Set) (┬½ΓÇó┬╗)-enTc.mp3
Billy Gillies - Daytona (Photographer Remix) (Cut From Angel Ace Set)-enTc.mp3
Billy Gillies - Daytona (Photographer Remix) (Cut From Saux Set)-enTc.mp3
Binary Finary vs. Sphere - High Stress (R3dub Remix) (Cut From Rank 1 Set)-enTc.mp3
Blister 13.0 - Lunes (Original Mix) (Cut From Solarstone Set)-enTc.mp3
BluEye - Night Lights (Original Mix) (Cut From Space Garden Set)-enTc.mp3
Bogdan Vix - Gratitude (Matt Bukovski Remix) (Set Rip)-enTc.mp3
Burufunk Feat. 3PM & Hiroko - Better Then Nothing (Boom Jinx and Soundprank Remix) (Cut From Gogzy Set)-enTc.mp3
Cate Kanell with Adrian & Raz - Into the Light (Cut From Susana Set)-enTc.mp3
Chable & Bonnici - Ride (Shiloh Remix) (Cut From Nickson Set)-enTc.mp3
Chris Oblivion & Serenity feat. Solnce - Catch Me When I Fall (Type 41 Mix) (Cut From Angel Ace Set)-enTc.mp3
Claus Backslash - Afterglow (Paul Todd Remix) (Cut From Saux Set)-enTc.mp3
Colldier - Until the Stars (M&D Substance & Bendz Remix) (Cut From Rank 1 Set)-enTc.mp3
Damian Wasse - Darkness (Cut From M.PRAVDA Set)-enTc.mp3
Daniel Kandi feat. Sarah Russell ΓÇô Change The World (Estiva Remix) (Cut From Tritonal Set)-enTc.mp3
Dave Cold - UNTITLED (Original Mix) (Cut From Cold Set)-enTc.mp3
Derek Ryan & Melissa Lin Feat. Charmy - Gravity (SNR Remix) (Cut From Koglin Set)-enTc.mp3
Dj Mark Knight - Your Love (ABGT 023 Rip)-enTc.mp3
Dreamy - Back To These Days (Johan Ekman Rework) (Cut From Cold Set)-enTc.mp3
eleven.five - Freedom (Cut From GO Set)-enTc.mp3
eleven.five - Freedom (Cut From Palagano Set)-enTc.mp3
eleven.five - With You (Cut From Palagano Set)-enTc.mp3
Emvy - Ginyo (Original Mix) (Cut From Raneem Set)-enTc.mp3
En-Core - Nothing (Cut From Nickson Set)-enTc.mp3
Encore - Nothing (Original Mix) (Cut From Shiver Set)-enTc.mp3
Essonita - When It's Over (Original Mix) (Cut From Gomrass Set)-enTc.mp3
First State - Humanoid (Cut From Bobina Set) (┬½ΓÇó┬╗)-enTc.mp3
Fleming & Lawrence - Beyond The Limit (Reaky Remix V1) (Cut From Allen&Envy Set)-enTc.mp3
Fran Anjuna - Sofia Cut From Palagano Set)-enTc.mp3
Gabriel & Dresden vs. D-Wayne - Shatter (Tellur Remix) (Cut From O'Neil Set)-enTc.mp3
Giuseppe Ottaviani and Eric Lumiere - Love Will Bring It All Around (Original Mix) (Cut From A&F Set)-enTc.mp3
Gradian & Rob Tailer - Iceberg (Original Mix) (Cut From Terry Set)-enTc.mp3
Hazem Beltagui - Solar Flare (Cut From Solarstone Set)-enTc.mp3
Hoyaa - The Better Side (Kaimo K Bangin' Mix) (Cut From Angel Ace Set)-enTc.mp3
I-Vision & David Folkebrant - Ghosts (Cut From Nickson Set)-enTc.mp3
Ice Upon Fire - Still Alive (Cut From Space Garden Set)-enTc.mp3
Illitheas pres. Nera - Your World (Ronny K. Remix) (Cut From Angel Ace Set)-enTc.mp3
Illitheas presents Nera - Your World (Ronny K. Remix) (Cut From tranzLift Set)-enTc.mp3
Infinity Life - Back To The Kazantip (Veselin Tasev Uplifting Remix) (Cut From Tasev Set)-enTc.mp3
Jasper Dietze - Alva (Cut From Ferry Set)-enTc.mp3