Action Bronson - Morey Boogie Boards.mp3
A-Mafia - Cuban Connection (Ft. Uncle Murda & Styles P).mp3
ASAP Rocky & ASAP Ferg - Take It Easy (Freestyle).mp3
Big Bank Black  - Burnt Out (Ft. Alley Boy & Rocko).mp3
Birdman - Tapout (Ft. Lil Wayne, Mack Maine & Nicki Minaj).mp3
Bow Wow - Pussy On My Mind.mp3
Bridget Kelly - Street Dreamin (Ft. Kendrick Lamar).mp3
Cap 1 - BrickFare (Ft. Dolla Boy).mp3
Cashius Green - Convertible Flow (Ft. Big K.R.I.T.).mp3
Chevy Woods - Tax It (Ft. Bow Wow).mp3
Chuck Inglish - Back Up (Remix) (Ft. Travi$ Scott).mp3
Compton Menace - Aint No Changing Me (Remix) (Ft. Wiz Khalifa & Game).mp3
Dizzy Wright - Maintain (Ft. Joey Bada$$).mp3
DJ Frosty - Tippin (Ft. Jim Jones).mp3
Drake - 5AM In Toronto.mp3
Eddie B - Marvelous (Ft. Action Bronson).mp3
Fred The Godson - 5AM In Blockwork (Freestyle).mp3
French Montana & Chinx Drugz - Pour It Up (Remix).mp3
Ghostface Killah & Adrian Younge - Enemies All Around Me (Ft. William Hart).mp3
Gucci Mane - Hell Yes.mp3
Havoc - Gone.mp3
Hit-Boy - Make Something (Ft. Kent M$ney, K. Roosevelt & Common).mp3
I-20 - Supacool.mp3
Jonathas - Southern Boi Shit (Ft. Dorrough).mp3
King B - Zoes (Freestyle) (Ft. Jadakiss & Young Adz).mp3
K-Major - Ready To Live (Biggie Tribute).mp3
LEP Bogus Boys - Commas (Ft. Mase & Lil Wayne).mp3
Maino & The Mafia - Real Recognize Real (Ft. Uncle Murda).mp3
Marco Polo - What's Wrong (Ft. Rakim).mp3
Mathematics - Men Of Respect (Ft. Raekwon, Method Man, Termanology, Cappadonna, Eyes Low & Bad Luck).mp3
Meek Mill - Started From The Bottom (Freestyle).mp3
Mysonne - Hollies (Ft. Ralph Random).mp3
Obie Trice - Pocket Full (Biggie Tribute).mp3
Phreshy Duzit - Hoes Down (Ft. Emilio Rojas).mp3
Problem - Hatin On Me (Ft. Iamsu).mp3
Raekwon - Whatever Baby (Ft. JD Era).mp3
Ransom - Hells Fury.mp3
Rocky Business - The Cattle List (Ft. Action Bronson).mp3
Sean Kingston - Beat It (Ft. Chris Brown & Wiz Khalifa).mp3
Snoop Dogg - Heaven.mp3
SpaceGhostPurrp - Juss Chill.mp3
Teeflii - Bad Bitches In Here (Ft. Nipsey Hussle).mp3
Test - Wut We Call It (Ft. Future & Mexico Rann).mp3
The Kid Daytona & DJ Ozone - Like This (Ft. GLC).mp3
Vado - DonΓÇÖt Make Me Do It (Ft. Ace Hood, Meek Mill, French Montana & DJ Khaled).mp3
Verse Simmonds - Who U Wit (Ft. Yo Gotti, Young Scooter & Trouble).mp3
Wyclef - Bugatti (Remix).mp3
Wyclef - Love Sosa (Remix) (Ft. Haitian Fresh).mp3
Yelawolf - Gangster (Ft. ASAP Rocky & Big Henry).mp3

follow @noles506! enjoy !!