Track List - not in order

Self Destruct - Pegboard Nerds
Reasons - Project 46
Awesome to the Max - Ephixa
Precipitate - AZEDIA
Night Rider - Draper
Vice - Droptek
Dat Voices - Insan3lik3
Dance to It - Tut Tut Child
Snake Eyes - Feint
Free My World - Direct
Hipster Cutthroat - DotEXE
Overcome(This Time) - Hot Date!
Morphine - Varien
The Mentalist - Mr FijiWiji
Letz Rock - Muzzy
Black Magic - Muzzy
Timewarp - Noisestorm
Dreams - Rogue
House - OVERWERK
The Anthem - Project 46, Varien & Ephixa
Harmony - Vicetone
The Phoenix - Rezonate
Because We Are - Soulero & Hellberg
Sexy Beast - Stereotronique
Rock the Flock - Televisor
Truth - Tristam
Too Simple - Tristam & Stephen Walking
Bumblebee - TVDS
Skywards - Two Thirds
Ocean City - Eminence
Monstercat Piano Mix - Evan Duffy
Best of 2012 Album Mix

Support the artists and buy Monstercat music as always

plz seed and comment
