Réalisateur(s) : Bernard Gonner
Présenté par : Patrick Sébastien
Genre : Divertissement
Durée : 2h25
Date de sortie : 26 Janvier 2013

14e saison pour LE PLUS GRAND CABARET de PATRICK SÉBASTIEN ! Une émission chargée de magie, d’humour et de visuels plus spectaculaires les uns que les autres !

Invités: Franck Dubosc, Philippe Geluck, Laury Thilleman, Pascal Obispo, Vincent Moscato, Anny Duperey, Aurélie Vaneck, Jeff Panacloc, Frank Michael, Natacha Amal, le professeur Cabrol, Jean-François Dérec..

Visuels:
Les Devils : grande illusion
Super Silva : aérien
Felipe Mejias : peinture sur sable
Troupe Zola : banquine
Diana Vedyashkina : dressage de chiens
Bernard Bilis : close-up
Darcy Oake : magie colombes
Fumagalli et ses Fuma Boys : burlesque
Sergio Lumbardini : magie cartes sur tango
Cirkafrika : troupe acrobaties sur mâts
Jeff Panacloc & Jean-Marc : ventriloque
Xavier & Chloé : duo main à main
Michel Lauzière : le vaisselophone
Eike von Stuckenbrok : équilibre sur mannequin
Dani Lary : les fantômes
Duo Mandoble : magie comique
Kathy Donnert : antipodiste
The Jasters : arbalètes et couteaux

Qualité : WebRiP
Source : France
Format : MKV
Langue : Français
Résolution : 704 x 400

Nombre et taille des fichiers : 1 X 880 Mo

Total du post : 880 Mo
