Ministry of Sound: This Is… Melbourne Bangers Album

24 Songs:

Chemical Energy (feat. Flea)	Will Sparks
Gyspy	SCNDL
Adrenalin (SCNDL Remix)	Sam La More & Gary Go
Afterdark	Joel Fletcher
Snapback (Will Sparks Remix)	Timmy Trumpet
Jumanji (feat. Feral Is Kinky)	J-Trick & Taco Cat
Gash King (Joel Fletcher Remix)	Uberjak'd
Party Bass (feat. The Twins) [Original Extended]	Bombs Away
Ohh Shhhh (Club Mix)	Chris Lake
Phoenix	Will Sparks
Turn That Thing Down (Deorro Remix)	Dirt Cheap!!!
S.W.A.T. Team (Reece Low Remix)	Chardy & Kronic
Zebra Bounce	NatNoiz
Stronger	Deorro
Big Fat (feat. Tarantula Man)	Tonic
Shakedown	Joel Fletcher & SCNDL
Run This Shit	SCNDL & Zoolanda
The Jam (J-Trick Remix)	Tom Piper, Daniel Farley & Snob Scrilla
Cool Without You (feat. Kid Sister) [Orkestrated Remix]	Tommie Sunshine & Disco Fries
Donâ€™t Trip	T. Rex
Pianos Peak	Chris Bullen & Haber
Keep Talking (Vocal Mix)	Jaimie Vlahos & Seany B
Ferry Elevator (Zoolanda Remix)	Surfdisco
This Isâ€¦ Melbourne Bangers (DJ Continuous Mix by Joel Fletcher)	Various Artists