
Tiffany Treasures (as Ester) [Anal Facial A2M IR]

I Got The Biggest Tits! Wet T-shirt Contest 3 (2003)

Scene 3. Tiffany Treasures, Darren James


Tiffany Treasures 

Performer AKA 	Bozena, Ester, Tifany, Tiffany
Birthday	September 28, 1973
Astrology	Libra 
Birthplace	Czech Republic 
Years Active	2003-2007 (Started around 30 years old)
Ethnicity	Caucasian
Nationality/Heritage	Czech
Hair Colors	Black/Brown/Dark Brown
Measurements	40-30-39
Height	5 feet, 8 inches (173 cm)
Weight	162 lbs (74 kg)
Tattoos	No data
Non-Ear Piercings	No data
Comments	There are no comments for this performer.
Website	No data
 
http://bayimg.com/dALPMaaEh 
http://bayimg.com/NaLpMAaeh