The Recommended Records Sampler from 1982.

Side A
Vogel: "Flaschenzug"
Faust: "Extract 5 from Faust Party Three: 'The Voice of the Pumpkin' "
Art Bears: "All Hail!"
Stormy Six: "Reparto Novit√†"
The Homosexuals: "Walk Before Imitate"
Joseph Racaille & Patrick Portella: "On ne Peut Plus Compter sur ses Doigts"
Feliu Gasul: "*"

Side B
The Black Sheep: "Strangelove"
Univers Zero: "Influences"
Aksak Maboul & The Honeymoon Killers: "Boss de Crosses dans le Doulos"
The Work: "Houdini"
Henry Cow: "Slice"
Henry Cow: "Viva Pa Ubu"
Decibel: "Radio Extract"

Side C
Art Zoyd: "Simulacres"
The Muffins: "Two Extracts from 'Chronometers' "
Heiner Goebbels: "Berlin Ku-Damm 12 April 1981"
Amos: "Steer Clear of England"
Conventum: "Commerce Nostalgique"
Hector Zazou: "Vera C"

Side D
This Heat: "Pool"
The Residents: "Walter Westinghouse"
R. Stevie Moore: "Pedestrian Hop" & "Copy Me"
Ron Pate: "I Talk to My Haircut"
Picchio Dal Pozzo: "Uccelin del Bosco"
Robert Wyatt: "The Internationale"

