
VA - Kiss FM Ultra Songs (2013)
Bobby Vena James Mcnally - Rain Fall Down On Me (Sample Sex A-Tonez Rmx)
Calvin Harris Ft. Florence Welch - Sweet Nothing (Adam Yngstrom Edit
Crazibiza - Beatbox (Original Mix)
DaddyΓÇÖs Groove Little Nancy - ItΓÇÖs Not Right, But ItΓÇÖs Okay (Fred V Grafix Remix)
Damien J Carter, Matt Devereaux, Michael Maze - Dare (Dj Cross Mix)
Deadmau5 - The Veldt Feat. Chris James (Tommy Trash Remix)
Dimitri Vegas, Like Mike - Tomorrowland Anthem 2012 (Original Mix)
Dj Favorite Feat. Kristina Mailana - Golden Song (Original Mix)
Fly Project Vs. Christopher S - Keep On Musica (Slider Magnit Mashup)
Fred V Grafix - Just A Thought (Feat. Reija Lee) (Vocal Mix)
House Punks Andee - ItΓÇÖs All In Your Head (Classic House Edit)
Jakwob - Electrify (Original Mix)
Kyau Albert - This Love (Original Mix)
Madonna - Girl Gone Wild (Lucky Date Extended Mix)
Metronomy - The Look (Camo & Krooked Remix)
Michael Canitrot Feat. Polina - Right On Me (Tv Noise Remix)
Micky Slim Emma Hewitt - Without You Tonight (Mr Sunny Mashup Extended)
Mylo - Drop The Pressure (Dada Life
Nianaro - Exhalation (Gor Remix)
Nicky Romero - Tension (Vocal Mix)
Parachute Youth - CanΓÇÖt Get Better Than This (Original Mix)
Psy - Gangnam Style (Johan K Ultra Sax Mix)
Rabbit Killer - Make Me Hate You (Original Mix)
Rihanna Ft. Calvin Harris - We Found Love (Mikael Wills Bootleg)
Sam And The Womp - Bom Bom (Dj Solovey Remix)
Sean Paul - She DoesnΓÇÖt Mind (Ghost Writer Dubstep Mix)
Sebastien Drums Rob Adans - Resonorg (Original Mix)
Seven Lions Feat. Shaz Sparks - Below Us)
Spencer And Hill Feat. Mimoza - Let Out Da Freak (Maison And Dragen Remix
Sub Focus Feat. Kenzie May - Falling Down (Original Mix)
Tomaz, Filterheadz - Sunshine (Uto Karem Remix)
Velvetine - The Great Divide (Seven Lions Remix)