Adiemus - Adiemus (Space Raven Bootleg) (Cut From RAM Set)-enTc.mp3
Air Night - Daisy (UCast Remix) (Cut From Anderson Set)-enTc.mp3
Airzoom & CJ SN - Until Forever (Akku Remix) (Cut From Romel Set)-enTc.mp3
Alter Future - October 3d (T-Amo Remix) (Cut From MIKE Set)-enTc.mp3
Amygdala - The Construct (Oxylerator III) (Cut From J00F Set)-enTc.mp3
Ana Criado & D-Mad - Little Signs Of Distance (Purple Stories Remix) (Cut From Ruben Set)-enTc.mp3
Anna Lee vs Igor Dyachkov & U-Jeen - Sakura (Original Mix) (Cut From Anderson Set)-enTc.mp3
Anna Lee vs. Igor Dyachkov & U-Jeen - Sakura (GDJB Rip)-enTc.mp3
Antonn & RomanR - What You Got (Original Mix) (Cut From Anderson Set)-enTc.mp3
Armin Van Buuren Featuring Trevor Guthrie - This Is What It Feels Like (Antillas & Dankaan Remix) (ASOT 608 Rip)-enTc.mp3
Ashy feat. Sound Quelle - Inner Feelings (1Touch Remix) (Cut From Anderson Set)-enTc.mp3
Beat Service - On The Edge (ASOT 608 Rip) (┬½ΓÇó┬╗)-enTc.mp3
BluEye - Night Lights (Dmitry Strochenko Remix) (GDJB Rip) (┬½ΓÇó┬╗)-enTc.mp3
Bobcat - Homeland (Original Mix) (Cut From Anderson Set)-enTc.mp3
Chalk n Cheese - Shades Of Blue (Original Mix) (Cut From Anderson Set)-enTc.mp3
Daniel Kandi Featuring Sarah Russell - Change The World (Estiva Remix) (-DaMaGeD- ASOT 608 Rip)-enTc.mp3
Dart Rayne & Yura Moonlight - Helix (GDJB Rip)-enTc.mp3
Dart Rayne & Yura Moonlight - Liberation (ASOT 608 Rip)-enTc.mp3
Digital Sixable - DonΓÇÖt Get Eaten By The Mountain Lion (Konektiv Remix) (Cut From Ruben Set)-enTc.mp3
DJ Rap - Freefalling (Dean Anthony & Nick Coles Remix) (Cut From Anderson Set)-enTc.mp3
Drop Community - Contact (Orignal Mix) (Cut From Anderson Set)-enTc.mp3
Eddy Karmona - Breaking (GDJB Rip) (┬½ΓÇó┬╗)-enTc.mp3
Facade & Holliday - Mafia (Facade Remix) (Cut From MIKE Set)-enTc.mp3
Gal Abutbul feat. Phillipa Joy - DonΓÇÖt Mind Waiting (Cut From Ruben Set)-enTc.mp3
Giuseppe Ottaviani Featuring Eric Lumiere - Love Will Bring It Around (ASOT 608 Rip)-enTc.mp3
Grube & Hovsepian Featuring Vice - Memory Lane (Skytech Remix) (GDJB Rip)-enTc.mp3
HeatBeat - #BOOM (ASOT 600 Rip)-enTc.mp3
High Rollers - The High Rise (Original Mix) (Cut From Anderson Set)-enTc.mp3
High Rollers - The High Rise (Tucandeo Remix) (GDJB Rip)-enTc.mp3
Igor Zaharov & Sober System - Joel (GDJB Rip)-enTc.mp3
Insert Name - UNTITLED (Cut From J00F Set)-enTc.mp3
Insid3r - Summerscape (Original Mix) (Cut From Uplift Set)-enTc.mp3
Johnny Yono - Orion (-DaMaGeD- ASOT 608 Rip)-enTc.mp3
Kent & Gian - Charlie Bravo (ASOT 600 Rip)-enTc.mp3
Kibo - Sleepless Nights (GDJB Rip)-enTc.mp3
Kill The Noise & Brillz & Minxx - Saturn (Kill The Noise Remix) (ASOT 600 Rip)-enTc.mp3
Lee Osborne - Milgauss (Iversoon & Alex Daf Remix) (Cut From Wizz Set)-enTc.mp3
Leon Beilmann - Counterlight (Seneca Remix) (Cut From Uplift Set)-enTc.mp3
Light & Wave - Feeling This City (NoMosk Remix) (ASOT 608 Rip)-enTc.mp3
Maarten de Jong - Wave Glider (-Short- ASOT 608 Rip)-enTc.mp3
Mark Sherry - Phantasmic (HeatBeat Remix) (ASOT 600 Rip)-enTc.mp3
MaRLo Feat. sswagger - Sure do! (MaRLo Tech-Energy Remix) (ASOT 608 Rip)-enTc.mp3
Max Graham Featuring Tania Zygar - Diamonds (ASOT 608 Rip)-enTc.mp3
Michael Harris - Rays Of Light (Original Mix) (Cut From Anderson Set)-enTc.mp3
Morttagua - Jupiter (Cut From Wizz Set)-enTc.mp3
Mosahar - Pure Emotion (Damian Wasse Remix) (Cut From Uplift Set)-enTc.mp3
Nab Brothers - Mylo (Nueva Remix) (Cut From Uplift Set)-enTc.mp3
Odonbat - Ethereal (Kago Pengchi Remix) (Cut From Tyas Set)-enTc.mp3
Oiryal - Elevation (Original Mix) (Cut From Anderson Set)-enTc.mp3
Outwalkers - Breath of Love (Original Mix) (Cut From Uplift Set)-enTc.mp3
Paul Rigel & Ezil - Restless (Cut From Ruben Set)-enTc.mp3
Paul Rigel & Ezil - Start New Life (Cut From Ruben Set)-enTc.mp3
Paul Webster Feat. Alana Aldea - Disappear (Clancy Remix) (ASOT 608 Rip)-enTc.mp3
Pizz@dox - Abracadabra (Original Mix) (Cut From Uplift Set)-enTc.mp3
PM AttitudE - Evolva (Cut From Ruben Set)-enTc.mp3
Progreg - Mirage (Cut From J00F Set)-enTc.mp3
Purple Stories - Surface Tension (ASOT 608 Rip) (┬½ΓÇó┬╗)-enTc.mp3
Ray Fishner - Waves Of Madness (Cut From J00F Set)-enTc.mp3
Rodrigo Deem - Toasty (ASOT 600 Rip)-enTc.mp3
Ruben de Ronde - On My Mind (Hazem Beltagui Remix) (-Short- Cut From Ruben Set)-enTc.mp3
Scott James & Alex Draym - Transit (Cut From Wizz Set)-enTc.mp3
Second Way - Mono Language (Sergey Shemet Remix) (Cut From Anderson Set)-enTc.mp3
Shato & Paul Rockseek - 74.75 (Original Mix) (ASOT 608 Rip)-enTc.mp3
Sickhead - Who I Am (Original Mix) (Cut From Anderson Set)-enTc.mp3
Speed Limits & T4L - Solar Guitar (Mario Ayuda & Chris Callado Remix) (Cut From Ruben Set)-enTc.mp3
Stephen J. Kroos - Truste (Cut From Henry Set)-enTc.mp3
Subtara - Alternate Reality (Cut From J00F Set)-enTc.mp3
Swilow & Diamans - Random (Original Mix) (Cut From Romel Set)-enTc.mp3
Talamanca - Secret (Cut From Ruben Set)-enTc.mp3
Tepes - Leiden (GDJB Rip)-enTc.mp3
Tofa - 7 Minutes To Love (Original Mix) (Cut From Anderson Set)-enTc.mp3
Tofa - This Is For You (Original Mix) (Cut From Anderson Set)-enTc.mp3
Venom One Featuring Adina Butar - Crashed and Burned (Club Mix) (GDJB Rip)-enTc.mp3
XGenic - Gigabyte (ASOT 600 Rip)-enTc.mp3
Zxcent - Mercury (Beatsole Remix) (Cut From Anderson Set)-enTc.mp3
