                    Jornada Mundial da Juventude - Rio 2013

                       O Melhor da Música Católica


INFORMAÇÕES


O CD e DVD da "Jornada Mundial da Juventude" reúnem as maiores referências da música católica brasileira. Padre Marcelo Rossi, Padre Reginaldo Manzotti, Padre Fábio de Melo, Padre Robson e muitos outros trazem mensagens de amor, paz e orações muito especiais. A expectativa para a Jornada Mundial da Juventude no Rio de Janeiro é enorme, tendo em vista que o último e único encontro realizado na América do Sul foi em 1987, em Buenos Aires, Argentina. Além disso, todos aguardam o Papa Francisco, primeiro latino-americano a assumir o mais alto cargo da Igreja Católica. A Jornada Mundial da Juventude foi instituída em 1985 pelo Papa João Paulo II, com o objetivo de levar a mensagem de Cristo a todos os jovens do mundo. Embora aconteça todos os anos em âmbito diocesano, a Jornada só convoca grandes encontros internacionais como o de 2013 em intervalos de dois a três anos. 



LISTA DE MÚSICAS


Esperança do Amanhecer - Vários


Tudo é do Pai - Pe. Fábio de Melo


O Homem (O Homem da Moto) - Pe. Reginaldo Manzotti


Força e Vitória - Eliana Ribeiro


Minha Benção - Pe. Marcelo Rossi


Meu Bom Deus - Pe. João Carlos


O Sol da Meia-Noite - Rosa de Saron


O Meu Lugar é no Céu - Dunga


Nos Braços do Pai - Padre Robson


Nossa Senhora - Padre Antônio Maria


Deus está Aqui (Noites Traiçoeiras) - Pe. Juarez de Castro


Oração Oficial da Jornada Mundial da Juventude - Dom Orani Tempesta



BÔNUS DVD TRACK (Músicas exclusivas do DVD)


Amor Intercessor - Pe. Gleuson Gomes


O Céu se Abre - Padre Hewaldo Trevisan


Amigos para Sempre - Pe. Omar, Pe. Juarez de Castro e Pe. Gleuson Gomes


Divino Diálogo - Ir. Kelly Patrícia



FICHA TÉCNICA


Artista / Banda: Pe. Marcelo Rossi / Pe. Fábio de Melo / Pe. Juarez de Castro / Pe. Reginaldo Manzotti / Eliana Ribeiro e outros.

Album: O Melhor da Música Católica.

Gênero: Religioso / Católico.

Ano de Lançamento: 2013.

Qualidade: 320kbps.

Formato do Arquivo: MP3.


RELEASE


JMJ 2013 - O Melhor da Música Católica - By TheCrow 


Retirado do site: trader.speed-share.org
