=======================================================
F B Page: Inspiron Trance
=======================================================


=======================================================
TWITTER : inspiron22
=======================================================	



Tracklist:

4 Strings Ft Seri - Ready To Fall (Inspiron)
A & Z - Gloom (Inspiron)
Above and Beyond - Alone Tonight (Inspiron)
Above And Beyond - Black Room Boy (Inspiron)
Adham Ashraf - Nile (Inspiron)
Aerofoil - Status Sphere - Wow (Inspiron)
Ahmed Romel - Concordia (Inspiron)
Ahmed Romel & Pizz@dox - Sirens & Patriot (Inspiron)
Air-T And Satelite - Light On (Inspiron)
Alexandre Bergheau - Damavand (Inspiron)
Alexandre Bergheau & Ahmed Romel - Ohelia (Inspiron)
Alexandre Bergheau & Tonny Nesse - Templar (Inspiron)
Aly And Fila Vs FKN Feat Jahala - How Long (Inspiron)
Aly And Fila Vs FKN Feat Jahala - How Long (Remixes) (Inspiron)
Ana Criado and Adrian and Raz - Dancing Sea (Inspiron)
Ancient Mind - Birds In Exile EP (Inspiron)
Andy Blueman - Time To Rest 2011 (Inspiron)
Andy Moor - Fake Awake (Inspiron)
Andy Moor & Betsie Larkin - Love Again (Inspiron)
Andy Tau - Breakfast For The Soul (Inspiron)
Arisen Flame - Don't Go - All The Way E.P. (Inspiron)
Arisen Flame - Love Story (Inspiron)
Arman Aydin - Shiga (Inspiron)
Armin van Buuren & Markus Schulz - The Expedition Remixes (Inspiron)
Armin Van Buuren And W&W - D# Fat (Inspiron)
Armin Van Buuren Vs Arty Nehalennia (Inspiron)
Astral Legacy - My Only Sunshine (Inspiron)
Avenger - Orca (Inspiron)
Bardalimov - Second Birth (Inspiron)
Beat Service & Neev Kennedy - Not This Time (Inspiron)
Beltek - Connect Us (Inspiron)
Ben Nicky - Pebbles (Inspiron)
Betsie Larkin And Ferry Corsten - Stars (Inspiron)
Blue Sense - Endless Blue (Inspiron)
BT - Skylarking (Inspiron)
Bushi - Creeper (Inspiron)
Cathy Burton - Heaven (Inspiron)
Chapter XJ - Fidelity (Inspiron)
Ciro Visone - First Coming (Inspiron)
Ciro Visone & Rita Visone - Aurora (Inspiron)
Claudia Cazacu - Emerge (Inspiron)
Claus Backslash - Terminal (Inspiron)
Cosmic Heaven - Broken Heart (Inspiron)
Craving ΓÇô Legacy (Inspiron)
C-Systems & Bushi - Ari (Inspiron)
C-Systems feat Hanna Finsen - To Be (Inspiron)
Dart Rayne and Yura Moonlight and Cate Kanell - Shelter Me (Inspiron)
Dash Berlin - Till The Sky Falls Down (Isaac Remix) (Inspiron)
Dash Berlin Ft. Chris Madin - Fool For Life (Inspiron)
Delta3 - Sleepless (Inspiron)
Denis Kenzo feat. Sveta B. - Lullaby Lonely (Inspiron)
Dennis Sheperd And Cold Blue Ft Ana Criado - Fallen Angel (The Remixes) (Inspiron)
DJ Eco - American Blues EP (Inspiron)
DJ Eco - American Blues EP (Part 2) (Inspiron)
D-Mad - I Love You So Much (Inspiron)
Dreamy - Symphonia (Inspiron)
Dreamy And Ikerya Project - Life Of Emotions (Inspiron)
Eddie Bitar - Rollercoaster (Inspiron)
Estiva & Cardinal feat. Arielle Maren - Wait Forever (Daniel Kandi's Bangin' Remix) (Inspiron)
Evo and Faveon - Solaris (Inspiron)
Eximinds - Mainbeat (Inspiron)
Farhad Mahdavi - Icy Nights - Winter Rain (Inspiron)
FKN feat. Jahala - This Is The Only Time (Inspiron)
FKN feat. Jahala - Tonight (Take Me Away) (Inspiron)
FKN feat. Jahala - Why (Inspiron)
FKN feat. Jahala - Why (Remixes) (Inspiron)
Frozen Skies feat Yana Vetrova - Always (Inspiron)
Gabriel & Dresden feat. Molly Bancroft - Tracking Treasure Down Revisited (Inspiron)
Global Influence - Depth Of My Dreams (Inspiron)
Hanski - Sunlight Showers (Inspiron)
Hazem Beltagui - Red Is The New Black (Inspiron)
Heatbeat - Ask The Angels Ask The Cat (Inspiron)
Heatbeat - Roses Never Cry - Chinpokomon (Inspiron)
IIO Ft. Nadia Ali - Rapture (Inspiron)
Indecent Noise - Phobia (Inspiron)
Iversoon & Alex Daffeat. Eskova - The Moonlight Shines (Inspiron)
Jason Pederson - Euphoric Ride (Inspiron)
John 00 Fleming - WKO (Inspiron)
John O'Callaghan & Full Tilt feat. Karen Kelly - Breathe (Inspiron)
Joren Heelsing - Last Hope (Inspiron)
Jorn Van Deynhoven - Godspeed (Inspiron)
JPS feat Mirva - Dream Into Reality (Inspiron)
Juventa - Bitsmash (Inspiron)
Karanda feat. Laura Shea - Agony (Inspiron)
K-Narf And Donito - Euphoria (Inspiron)
Lange And Audrey Gallagher - Our Way Home  (Remixes) (Inspiron)
Las Salinas - Chipsy Kings (Inspiron)
Leven Mervox - Silent Scream (Inspiron)
Leven Mervox - Waiting The Past (Inspiron)
LTN - Daylight (Inspiron)
Luigi Lusini Pres Galaxia LL - Dont Wanna Be Alone (Inspiron)
Markus Schulz - The Spiritual Gateway (Transmission Theme 2013) (Inspiron)
Masoud - Here We Go - Skyward (Inspiron)
Matt Bukovski - Phoenix (Inspiron)
Matt Bukovski vs Andy Elliass & Abys - Cheops (Inspiron)
Moonbeam - The Random (Inspiron)
Moonbeam - The Raven (Inspiron)
Myon & Shane 54 feat. Aruna - Lights (Inspiron)
NDS and Blue - The Diva (Inspiron)
Neptune Project feat. Polly Strange - The Inside (Inspiron)
Nitrous Oxide and Adam Kancerski Pres Husaria - Jade (Inspiron)
Odonbat - The Wind (Inspiron)
Oliver V. - Niamey - Washington DC (Inspiron)
Omnia - The Light (Inspiron)
Orjan Nilsen - La Guitarra, Scrubs (Inspiron)
Ost & Meyer vs 7 Skies - Dharma (Inspiron)
Ozo Effy - The Great Journey (Inspiron)
Philippe El Sisi - Darkness Falls (Inspiron)
Protoculture - Laguna (Inspiron)
Proyal - Prophet Of Mercy (Inspiron)
Purple Stories & Static Blue ΓÇô Seoni (Inspiron)
Raneem - Moonchild (Inspiron)
Rene Ablaze and Charles McThorn - Purple (Inspiron)
ReOrder and First Effect - Prometheus (Inspiron)

+ many more !!!

Enjoy
(Inspiron)