CD 1

    Tony Carreira - Cada Historia tem Dois Lados
    Rita Guerra - Preciso de Ti (Agora)
    Paulo Gonzo - Só Gestos
    Adriana Lua - Se Você quer me Amar
    Leandro - Que Mal te fiz Eu (Diz-Me)
    Berg - Palavras
    Agata - Fui Eu, Fui Eu
    Angélico, Rita Guerra - Quando te Lembrares de Mim
    Marcelo Costa - Esta Balada que te Deu
    Wando - Romântico Brasileiro, Sem Vergonha
    José Malhoa - E Como Sempre
    Romana - Não Quero Mais Ilusão
    Beto e Menito - Porto Côvo
    João Portugal - Até o Fim
    Menito Ramos - A Noite Grita por Mim
    José Alberto Reis - Mas Antes de Partir
    Miguel e André - Se Te Apanho, Se Te Agarro
    Maria Teresa - Faltam-me as Palavras
    Bandalusa - Faz de Conta


CD 2

    David Carreira - Só Tu e Eu
    Beto - Posso Jurar
    Adelaide Ferreira - Esqueço-me de te Esquecer
    Angélico - Gostasses de Mim
    Lucas & Matheus - Numero Um
    FF - Aqui Sem Ti (Acústico)
    Toy - Vou Chorar Outra Vez
    Micaela - Quem te Disse quem te Disse
    Anjos - Era para Sempre
    Jose Cid - Um Louco Amor
    Marco Paulo - Na Hora do Adeus (Não Digas Nada)
    Pedro Miguel - Diz-me Agora (Em Meus Olhos)
    Santamaria - Leva-me Contigo (Num Sonho)
    Ricardo & Henrique - O Convite
    Suzanna - Mistério de quem Ama
    Fernando Santana - Amo-te (Por Amor Tudo Farei...)
    Paulo Ribeiro - Dois Corações e uma História