=======================================================
Site: http://www.inspirontrance.com/
=======================================================


=======================================================
F B Page: Inspiron Trance
=======================================================


=======================================================
TWITTER : inspiron22
=======================================================	
	

This contains  (147 Releases) (8 GB)	((Can't include the full tracklist, please check the file list for more info!!))


RELEASES:


A.R.D.I. feat. Allam - Nevermore (Inspiron)
Above And Beyond Vs Andy Moor - Air For Life (Inspiron)
Aeden - Get On Down (Inspiron)
Aeden - Just In Love (Inspiron)
Aeden ΓÇô Sonata (Inspiron)
Ahmed Romel ΓÇô Moon Glow (Inspiron)
Airbase - Modus Operandi (Inspiron)
Alex Larichev - Freedom Fighter (Inspiron)
Alex M.O.R.P.H. - New York City (Inspiron)
Alexander Popov - Lost Language (Inspiron)
Alexander Popov Feat. Kyler England ΓÇô My World (Inspiron)
Alexandre Bergheau ΓÇô Ca-Mind (Inspiron)
Alexey Ryasnyansky - Cosmotronic (Inspiron)
Ali Wilson - A Dream Apart (Inspiron)
Aly & Fila feat. Chris Jones - Running Out Of Time (Inspiron)
Andrew Rayel - Zeus - Musa (Inspiron)
Aneym And Suncatcher - Together Again (Inspiron)
Angry Man - Mescaline (Inspiro)
Anthony Mayer - Tyrantic (Inspiron)
Antony Waldhorn ΓÇô Cerberus (Inspiron)
Araya and Mark Dreamer - Caldera (Inspiron)
Araya and Mark Dreamer - Caldera (Inspiron)
Araya and Mark Dreamer - Con Rafal (Inspiron)
Armin van Buuren feat. Trevor Guthrie - This Is What It Feels Like (Inspiron)
Armin Van Buuren Pres Gaia - Tuvan (Ahmed Romel Bootleg) (Inspiron)
Avenger - Emerge (Inspiron)
Beat Service - Aurora - Metro (Inspiron)
Beat Service - On The Edge (Inspiron)
Ben Alonzi and Adriz - Ingenious (Inspiron)
Ben Gold ΓÇô Mesocyclone - Why Not (Inspiron)
Billy Gillies - Daytona (Inspiron)
Blue Silence - A Whole World Better (Inspiron)
BluEye - Another Day On Earth (Inspiron)
Boom Jinx, Maor Levi and Ashley Tomberlin - When You Loved Me (Inspiron)
Brian Cameron - Fatality (Inspiron)
Chicane & Ferry Corsten feat. Christian Burns - One Thousand Suns (Inspiron)
Chris Hampshire - Ninety Four (Inspiron)
Chris North - A Drop In The Ocean (Inspiron)
Chris Porter - The Sky At Night (Inspiron)
Chris Schweizer & Tomas Heredia - Darksiders (Inspiron)
Chris Turner vs Running Man - The Persian Twist (Inspiron)
Ciro Visone - Deliverance (Inspiron)
Conjure One Feat Leigh Nash - Under The Gun (Inspiron)
Singles + RemixesCosmic Gate - Storm Chaser (Inspiron)
Singles + RemixesDamian Wasse - Amnesia (Inspiron)
Damian Wasse - For World For Earth - Sunset (Inspiron)
Darren Porter - Spellbound (Inspiron)
Defcon Audio Feat Julie Harrington - Lost In You (Inspiron)
Dennis Pedersen - Badittude (Inspiron)
Eco - When Im Gone - We Watched The Sunrise Till Our Eyes Burned Out (Inspiron)
Ellie Lawson & Matt Bukovski - Breathe In, Breathe Out (Inspiron)
Evave - Daylight (Inspiron)
Falcon - Hayabusa (Inspiron)
Fisherman & Hawkins - A Place Called Yesterday (Inspiron)
Foyle And Zo - Simple Things (Inspiron)
Fred Baker - A New Life On Earth (Inspiron)
Giuseppe Ottaviani - Love Will Bring It All Around (Inspiron)
Gregory Esayan - Sweet Insomnia (Inspiron)
Hardwell Ft. Amba Shepherd - Apollo (Inspiron)
Hazem Beltagui feat Charlotte Haining - Of What We Once Had (Inspiron)
Heatbeat - BOOM (Inspiron)
Hyperbits feat. Skela - Close Your Eyes & See (Inspiron)
Insid3r - Summerscape (Inspiron)
Izzy Meusen and Irena Love - Pieces In The Dust (Inspiron)
Jace Williams - Hope and Pray (Inspiron)
Jamie Walker - Boulevard (Inspiron)
Jamie Walker - For A Lifetime (Inspiron)
Jens Jakob - 22
JES - Imagination (Inspiron)
Johan Gielen vs Virtual Vault - Intensive (Inspiron)
John O'Callaghan and Ronski Speed - Sincerely (Inspiron)
Juventa And Karanda Feat. Roxanne Barton Ethereal (Inspiron)
Kago Pengchi & Alexan - Sagarmatha (Inspiron)
Kelly Andrew - The Incursion (Inspiron)
Kiholm & Kris OΓÇÖNeil Feat. Roberta Harrison ΓÇô Nothing Remains (Inspiron)
Klauss Goulart & Mark Sixma - Rio (Inspiron)
Kyau And Albert Featuring Damae - Velvet Morning (Inspiron)
Lange And Genix - Immersion (Inspiron)
Lange and Susana - Risk Worth Taking (Inspiron)
Late Night Alumni - Empty Streets (Inspiron)
Lence and Pluton - Native Home (Inspiron)
Leolife - Control (Inspiron)
Liuck and XB feat Fenja - Prince and Beggar (Inspiron)
M.I.K.E. - Canvas (Inspiron)
Marc Simz Feat. Emma Lock - Angels (Inspiron)
Mark Nails and Davide Leonardo - Lynda (Inspiron)
Mark Pledger and Rake feat Sabrina - Feel You In The Sound (Inspiron)
Mark Sherry - Phantasmic (Inspiron)
MaRLo - BOOM (Inspiron)
Matt Chowski ΓÇô One Wish (Inspiron)
Matt Eray feat Claire Willis - A Milion Miles (Inspiron)
Mike Foyle and ReFeell - Legacy (Inspiron)
Mike Koglin vs Genix - Dyno (Inspiron)
Miroslav Vrlik - Backstage (Inspiron)
Misja Helsloot feat Fisher - Inspire (Inspiron)
Mohamed Bahi - Casablanca (Inspiron)
Nash & Pepper - Ushuaia Memories - Panamarenko (Inspiron)
New World ΓÇô Rise Above (Inspiron)
Nick The Kid & The Nameless Girl - Bright Light (Remixes) (Inspiron)
Odonbat ΓÇô Ethereal (Inspiron)
Orjan Nilsen - Violetta (Inspiron)
Overseas - Baja (Inspiron)
Paul Oakenfold - Southern Sun, Ready Steady Go (Inspiron)
Photographer - Tic Tac (Inspiron)
Pizz@dox - Abracadabra (Inspiron)
Pizzadox - Andromeda (Inspiron)
Proyal - 1001 Nights (Inspiron)
Singles + RemixesPurple Stories - Surface Tension (Inspiron)



Enjoy
(Inspiron)