Lou Valmont [Anal Facial]

No Sun No Fun (2000)

Scene 6. Lou Valmont, Ian Scott


LOU VALMONT
Performer AKA 	Lou Valmon, Linda Ross, Lou
Birthday	??/??/1976
Astrology	No data 
Birthplace	France 
Years Active	2000-2002
Ethnicity	Caucasian
Nationality/Heritage	French
Hair Color	Blond
Measurements	33E
Height	5 feet, 6 inches (168 cm)
Weight	123 lbs (56 kg)
Tattoos	Design on left shoulder blade
Non-Ear Piercings	No data
Comments	There are no comments for this performer.
Website	No data
 
http://bayimg.com/OALAeaaeI