My thanks to the original seed here on the Pirate Bay for yet one more classic from this series of 'modern classic' Music Video's.  No holds barred mind you and not for the prudish of this World but at 720p HD and logo free who cares about that.

As always I have just played my part in not only helping the original seeds to get the ISO disc image out, but as you can see below, splitting (no loss of quality at all) the ISO disk image into individual Music Video MPEG2 or VOB files which I have then tagged correctly for professional VJ use.

720 HD 16:9 but one or two still letter box format as America it would seem still can not quite get there heads round Aspect Ratio sigh....  This is a GREAT selection and if I could I would purchase it legally, but alas.. It is not for sale where I live... grrrr...

August Alsina - Down Right Now [Video].VOB
B.o.B - Chandelier [Video].VOB
Bullitts - They Die By Dawn [Video].VOB
Chrystian - Go [Video].VOB
Disclosure - When A Fire Starts To Burn [Video].VOB
DJ Muggs feat Chuck D & Jared from HED PE - Wikid [Video].VOB
Dream - IV Play [Video].VOB
Elijah Blake - X.O.X. [Video].VOB
Eric Bellinger - ASAP [Video].VOB
FKi - Hello [Video].VOB
Flosstradamus & DJ Sliink - Crowd Control [Video].VOB
Goapele - Undertow [Video].VOB
Hit Boy - Fan [Video].VOB
Iggy Azalea - Bounce [Video].VOB
Jared Evan - Blue [Video].VOB
Jared Evan - The Devil Wears Prada [Video].VOB
Jeremih - Feel The Bass [Video].VOB
Joel Culpepper - Heaven [Video].VOB
John Legend - Who Do We Think We Are [Video].VOB
K Roosevelt - Do Me Now [Video].VOB
Kenzie May - Hide & Seek [Video].VOB
Lonely Island - Go Kindergarten [Video].VOB
Lonely Island - SPELL IT OUT [Video].VOB
Major Lazer - Watch Out For This (Bumaye) [Video].VOB
Major Lazer ft Bruno Mars 2 Chainz & Tyga - Bubble Butt [Video].VOB
Reggie Watts - If You're Fucking, You're Fucking (Explicit) [Video].VOB
Reggie Watts - Reg Rolled [Video].VOB
Riff Raff & Andre Legacy - Non Stop [Video].VOB
Sammie - Put It In [Video].VOB
Sensato ft Pitbull - Booty Booty [Video].VOB
Snoop Lion ft Miley Cyrus - Ashtrays and Heartbreaks [Video].VOB
Stafford Brothers - Hello [Video].VOB
Talib Kweli - Come Here [Video].VOB
Tank - Shots Fired [Video].VOB
TGT - Sex Never Felt Better [Video].VOB
Theophilus London ft Menahan Street Band - Rio [Video].VOB
TI ft Ceelo Green - Hello [Video].VOB
Tyga - For The Road [Video].VOB
Vampire Weekend - Diane Young [Video].VOB
Wrekonize - Freak [Video].VOB

Rigmar Radio STILL rockin' the Free World since 1967 :)  I love the Pirate Bay THANK YOU ADMIN FOR ALL THE HARD WORK AND HASSEL FOR FREEDOM AND MUSIC