               Jornada Mundial da Juventude - Rio 2013

                   O Melhor da Música Católica


INFORMAÇÕES


O CD e DVD da Jornada Mundial da Juventude reúnem as maiores referências da música católica brasileira. Padre Marcelo Rossi, Padre Reginaldo Manzotti, Padre Fábio de Melo, Padre Robson e muitos outros trazem mensagens de amor, paz e orações muito especiais. A expectativa para a Jornada Mundial da Juventude no Rio de Janeiro é enorme, tendo em vista que o último e único encontro realizado na América do Sul foi em 1987, em Buenos Aires, Argentina. Além disso, todos aguardam o Papa Francisco, primeiro latino-americano a assumir o mais alto cargo da Igreja Católica. A Jornada Mundial da Juventude foi instituída em 1985 pelo Papa João Paulo II, com o objetivo de levar a mensagem de Cristo a todos os jovens do mundo. Embora aconteça todos os anos em âmbito diocesano, a Jornada só convoca grandes encontros internacionais como o de 2013 em intervalos de dois a três anos.


MÚSICAS


1. Esperança Do Amanhecer - Adriana, Eliana Ribeiro, Guilherme Sá, Leandro Souza, Olívia Ferreira e Walmir Alencar

2. Tudo É Do Pai - Padre Fábio De Melo Ao Vivo

3. O Homem (O Homem Da Moto) - Padre Reginaldo Manzotti Ao Vivo

4. Força E Vitória - Eliana Ribeiro Ao Vivo

5. Minha Bênção - Padre Marcelo Rossi Ao Vivo

6. Meu Bom Deus - Pe. João Carlos

7. O Sol Da Meia-Noite - Rosa De Saron Ao Vivo

8. O Meu Lugar É O Céu - Dunga Ao Vivo

9. Amor Intercessor - Pe. Gleuson Gomes

10. O Céu Se Abre - Padre Hewaldo Trevisan

11. Amigos Para Sempre (Friends For Life) - Pe. Omar, Pe. Juarez De Castro e Pe. Gleuson Gomes

12. Divino Diálogo - Ir. Kelly Patrícia Ao Vivo

13. Nossa Senhora - Padre Antônio Maria Ao Vivo

14. Deus Está Aqui (Noites Traiçoeiras) - Pe. Juarez De Castro

15. Oração Pela Família - Pe. Zezinho, Scj Ao Vivo - Part. Esp.: Cantores De Deus, Adriana Melo, Giba E Geraldo Jr.

16. Oração Oficial Da Jornada Mundial Da Juventude - Dom Orani Tempesta 


DADOS TÉCNICOS

Título Original: O melhor da música católica - JMJ RIO 2013
Editora: Som Livre
Gênero:  Clipes de Músicas
Data de Lançamento: 2013.
Tempo de Duração: 72 minutos.
Formato dos Arquivos: .ISO.
Resolução: 720X480 pixels.
Formato da Tela: 4:3
Video Codec:  MPEG2 Video.
Audio Codec: Dolby AC3 48000Hz stereo 192kbps.
Idioma: Português
Legenda: Português, Inglês, Espanhol

Qualidade do Vídeo: DVD-R FULL.


RELEASE


JMJ_2013_DVDR_BY_THECROW


Retirado do site: trader.speed-share.org
		