AR-AB - Want War (Ft. Trae Tha Truth).mp3
Arlis Michaels - OKC.mp3
Big Bank Black - Secret Lover (Ft. Trouble & Gucci Mane).mp3
Big K.R.I.T. - Shine On (Ft. Bun B).mp3
Chris Brown - Let The Blunt Go.mp3
Chris Luck - Pop Sum n (Ft. Jim Jones).mp3
Consequence - Little Precious Cargo (Ft. Rell).mp3
Currensy - Kingpin.mp3
Dorrough - After Party.mp3
Durag Dynasty Ft Evidence ΓÇô Spiral Event (Prod. The Alchemist).mp3
Fredo Santana - Rollie On My Wris (Ft. Juelz Santana).mp3
Hit-Boy - T.U. (Ft. Audio Push, Problem & Juicy J).mp3
Hot Rod - Grown Up.mp3
Jared Evan - Pro Create (Ft. Action Bronson).mp3
Jim Jones - Harlem Shake (Remix).mp3
Kid Cudi - Immortal.mp3
Kid RED - That Nigga (Ft. Chris Brown).mp3
Kid Vishis - Straight Out Of Detroit (Ft. Royce Da 5 9).mp3
King Louie - V12 Nut (Ft. Yella).mp3
Metta World Peace - Point Of No Return (Ft. Tech N9ne).mp3
N.O.R.E (a.k.a. P.A.P.I.) - Fowl Niggaz.mp3
OJ Da Juiceman - Ziplock (Ft. Gorilla Zoe).mp3
Passion Pit - Constant Conversations (Remix) (Ft. Juicy J).mp3
P-Money - Welcome To America (Ft. Skyzoo & Havoc).mp3
RC & The Gritz - That Kinda Girl (Ft. Snoop Dogg & Raheem DeVaughn).mp3
Ricky Blaze - Top Shottas (Ft. Maino).mp3
Roosh Williams - Beautiful Thing (Ft. Action Bronson) .mp3
Scotty Boi - Head Shot (Ft. Gunplay & 40 Cal).mp3
Shawty Lo - What Make Her (Ft. Trouble).mp3
Styles P - Hater Love (Ft. Sheek Louch).mp3
Talib Kweli - The Traveller.mp3
Tha Dogg Pound - L.A. Here's 2 U (Ft. Snoop Dogg).mp3
Tone Trump - What You Smoking On (Ft. Warren G & Krutch).mp3
Tony Jones - Everything You Want (Ft. Game).mp3
Torae - Whats Love (Ft. Pharoahe Monch).mp3
Troy Ave - The Symphony (Ft. BSB).mp3
Yelawolf - F.A.S.T RIDE.mp3

F-book @thachronicizback , twitter @noles506