Depois de um exaustivo dia de trabalho, o jovem bombeiro Jeremy Coleman (Josh Duhamel) sai para beber com os amigos – mas acaba presenciando um crime brutal. Auxiliando o detetive Mike Cella (Bruce Willis), ele concorda em identificar o agressor. Mas o assassino comprova que sabe quem ele é e começa a ameaçá-lo. Forçado a abandonar sua carreira e integrar o programa de proteção às testemunhas, Jeremy tenta reconstruir sua vida. Mas uma inesperada virada judicial coloca o criminoso de volta nas ruas. Desta forma, o ex-bombeiro vai se unir a uma gangue rival para proteger a si mesmo e às pessoas que ama, combatendo fogo com fogo.

Título no Brasil: Fogo Contra Fogo
Título no Original: Fire with Fire
Ano de lançamento: 2013
Gênero: Ação
Direção: David Barrett 
Duração: 1 horas e 37 minutos


Tamanho: 800MB
Extensão do Arquivo: Tipo de Compartilhamento: http;
Idioma do Audio:   Inglês |   Português
Legendas: anexada(s) ao Post
Qualidade do Vídeo:BD-Rip
Ano de Lançamento: 2013

Vídeo Codec: Xvid
Audio Codec: MP3
Resolução: 640 X 272
Formato de Tela: WideScreen(16x9)

===================================================================================

After an exhausting day at work, the young firefighter Jeremy Coleman (Josh Duhamel) goes out drinking with friends - but ends up witnessing a crime brutal. Assisting the detective Mike Cella (Bruce Willis), he agrees to identify the perpetrator. But the killer proves he knows who he is and starts to threaten him. Forced to abandon his career and join the witness protection program, Jeremy tries to rebuild his life. But an unexpected turn of judicial puts the criminal back on the streets. Thus, the former firefighter will join a rival gang to protect yourself and the people you love, fighting fire with fire.

Title in Brazil: Fire Fire
Title in Original: Fire with Fire
Release year: 2013
Genre: Action
Directed by: David Barrett
Duration: 1 hour and 37 minutes


Size: 800MB
File Extension: Type Share this: http;
Audio Language: English | Portuguese
Subtitles: Attached (s) to the Post
Video Quality: BD-Rip
Release Year: 2013

Video Codec: Xvid
Audio Codec: MP3
Resolution: 640 X 272
Screen Format: WideScreen (16x9)