Lots of remixes off well known tracks! =)


Adam K & Kaskade - Raining (Mats Gulbrandsen Remix)
Afrojack vs Robin S - Show Me Replica Love (Mats Gulbrandsen Mashup)
Alesso vs Daft Punk vs Sandro Silva & Quintino vs Example vs Hardwell - The Way around your epic head (Mats Gulbrandsen Megamash) - EXCLUSIVE
Arty vs Ian Carey - When I see you Rising (Alesso Mix) (Mats Gulbrandsen Mashup)
Avicii - Fade Into Darkness (Mats Gulbrandsen Remix)
Bassfinder & Mike Neptune ft Hillary Jean - Last To Know (Mats Gulbrandsen Remix)
Black Eyed Peas vs Carly Rae Jepsen - Call me maybe (Mats Gulbrandsen & Mario Santiago Remix)
Bingo Players - When I dip (Mats Gulbrandsen bootleg)
Blackstreet ft Dr.Dree - No Diggity (Dunisco giggity mix)
Calvin Harris ft Ne Yo - Lets Go (Mats Gulbrandsen & Primacy Funk Remix)
Carly Rae Jepsen - Call me maybe (Mats Gulbrandsen Remix)
Cedric Gervais - Molly (Mats Gulbrandsen Remix)
Chimeric & Mats Gulbrandsen - 1837 (Original mix)
Chris Brown ft David Guetta - Dont wake me up (Mats Gulbrandsen Remix)
Coast 2 Coast - Home (Mats Gulbrandsen 2012 Remix)
Coldplay - Paradise (Mats Gulbrandsen & Chimeric Remix)
Da hool - Meet her at the love parade (Mats Gulbrandsen 2012 Remix)
Daft Punk - Digital Love (Mats Gulbrandsen 2012 Rewakening)
Daft Punk vs Deadmau5 & Glenn Morrison - The Reward Is Work (Mats Gulbrandsen Mash)
Donkeyboy - City Boy (Mats Gulbrandsen city mix)
Donkeyboy - Pull of the eye (Mats Gulbrandsen Pull Mix)
Duck Sauce - Big Bad Wolf (Mats Gulbrandsen Wolf mix)
Eminem - Real Slim Shady (Mats Gulbrandsen Goes Hard Remix)
Empire of the sun - We are the people (Mats Gulbrandsen Remix)
Erik og Kriss ft Byz - Ølbriller (Mats Gulbrandsen Remix)
Evelyn Champagne King - Shame (Mats Gulbrandsen Remix)
Fedde Le Grand & Nicky Romero ft Matthew Koma - Sparks (Mats Gulbrandsen Remix)
Florence and The Machine - You`ve Got the love (Mats Gulbrandsen Remix)
Fragma, Dada Life - Kick Toca Out (Mats Gulbrandsen Mash)
Funky Rezz - Flashing Light (Mats Gulbrandsen Radio Remix)
Hatiras, Nom De Strip ft Ambush, DJ Obek - Put Nothing Up (Mats Gulbrandsen Mash)
HIFI vs Dave Darell vs Fedde Le Grand - Controll Flash (Mats Gulbrandsen Mash)
Jose Ribera & Manolo Ribera - Broken Piano (Mats Gulbrandsen Remix)
Kelis - Milkshake (Mats Gulbrandsen Radio Remix)
Kelis - Milkshake (Mats Gulbrandsen Remix)
Kernkraft 400 - Zombie Nation (Mats Gulbrandsen Remix)
Kings Of Convenience - I`d Rather Dance With You (Mats Gulbrandsen Club mix)
LidoLido - Different (Mats Gulbrandsen Radio Remix)
LidoLido - Different (Mats Gulbrandsen Remix)
Lt Wee ft. Blackman & Essa Cham - I Don't Wanna Fall In Love (Mats Gulbrandsen & José Zapata Remix)
Lykke Li & Sam Young vs Sebastian Ingrosso & Tommy Trash - Reload Rivers (Mats Gulbrandsen Mash)
M83 & Eric Prydz vs Maroon 5 & Christina Aguilera - Midnight Jagger (Mats Gulbrandsen Private Mashup)
Maggio & Don Palm vs Hardwell - Spaceman Jag (Mats Live Edit)
Maria Mena - Mitt Lille Land (Mats Gulbrandsen Remix)
Mats Gulbrandsen - Down (Original Mix)
Mats Gulbrandsen ft droydi - Requests (Blade Mix)
Me & My Monkey - The End (Mats Gulbrandsen & droydi Remix)
Michael Califan vs Dada Life - Feed the Resurection (Mats Gulbrandsen bootleg)
Mousse T - Horny (Mats Gulbrandsen & Primacy Funk 2012 Remix)
Pryda vs Ivan Gough & Feenixpawl ft Georgi Kay - My Allein Mind (Mats Gulbrandsen Bootleg)
Ram Jam - Black Betty (Mats Gulbrandsen & droydi Ramix)
Reflekt ft. Delline Bas - Need to feel loved (Mats Gulbrandsen 2012 Rework)
Royksopp ft Susanne Sundfør - Running To The Sea (Mats Gulbrandsen Bootleg)
Sidney Samson - Riverside (Mats Gulbrandsen 2012 Remix)
The White Stripes - Seven Nation Army (Mats Gulbrandsen 2012 Remix)
The White Stripes ft Sandro Silva & Quintino - Seven Nation Epic Army (Mats Gulbrandsen Epic Mix)
Tiesto & Hardwell ft. Sugg' the MC - Zero 76 (Mats Gulbrandsen exclusive extended mix)
Wolfgang Gartner, Daft Punk - Love Technologic War (Mats Gulbrandsen Mash)




