Tracklist : 

B4ssTee - Music Time
Benny Page - Turn Down The Lights
Bitty McLean - Walk Away From Love (Isaac Maya Remix)
Caspa - Custard Chucker
Chrispy - Roll Out
Cotti - I Dont Give a Dub
Cragga - Please Mr Postman
Crissy Criss - Kick Snare
Cutline - Let Me Go
Darqwan - Megatection
Datsik - Gizmo
Deekline - I Dont Smoke
Desimal - Afterlife
Digital Mystikz - Thief In Da Night
Disaszt - Sposh
DJ D2 - Give a Little Love
DJ Fresh - Gold Dust (Shy FX Edit)
DJ Fresh - Louder (Doctor P, Flux Pavilion Remix)
DMT - Excite Me
Dub Breakah - Iman Dub
Dub From Atlantis - Silly Little Things (Cymatic Remix)
Dubba Johnny - 9 Drop
Excision & Datsik - Deviance
Fish Finger & Dread Foxx - Fund Raisers
Freestylers - Cracks (Flux Pavilion Remix)
Freestylers ft Pendulum - Painkiller
Giant - Drumstick
Goku ft Sarah Burgess - Lost In Time
Gramatik - Who Got Juice
Hybrid Minds - Leaving
Jah Fury - Far East Gate
Katy B - On a Mission (Pete Miles Remix)
Knife Party - Bonfire
Knife Party - Centipede
KOAN Sound - Sly Fox
Laid Blak vs Drifta - Red
Lenzman ft Riya - Open Page
Lomax & Kubix - Things To Come
Lord Uptown - Revolt Into Style
Lotek ft Spikey Tee - Rebel Hifi
L-wiz - Cuffs
L-wiz - Girl From Codeine City
L-wiz - Pirates
Matta - Feel The Heat
Megaclown - Space Face
Oh Land - Sun Of a Gun (Jacob Plant Remix)
Pendulum - Blood Sugar
Quba - From Romania
Raindrops - Flinch Remix
Rihanna - Rude Boy (Chrispy Remix)
Rita Ora ft Tinie Tempah - R.I.P (Delta Heavy Remix)
Roksonix - Music In Me
Subscape - Shanghai
Unknown - No Sunshine
Utah Jazz ft Alex Reece - Everything Is Everything
Zomboy ft Belle Humble - City 2 City