DESCRIÇÃO
Box Moda Sertaneja
A moda de viola é uma expressão da música caipira nacional que se destaca como sendo seu maior exemplo, entre outros ritmos formados a partir das toadas, canas-verdes, pagodes, chibatas e demais estilos dentro desse gênero. Retrato da autêntica música caipira, a moda de viola caracteriza-se pelos solos de violão, pelas sanfonas e pelos ver¬sos intercalados por refrões extensos. A Coletânea Moda Sertaneja - Uma Grande História resgata o gosto pela boa e velha moda de viola, trazendo grandes clássicos deste estilo, nas vozes de intérpretes consagrados e ídolos de uma geração. São 4 CDs que vão resgatar a memória da música caipira e possibilitar reviver sucessos em gravações históricas, onde os cantores se soltam e expressam seus sentimentos com muita emoção. É um registro de qualidade de can¬ções que são a raiz do sertanejo, englobando décadas de sucessos. Destaque para Rei do Gado - Tião Carreiro & Pardinho, Ainda Ontem Chorei de Saudade - João Mineiro & Marciano, Cavalo Preto - Palmeira & Luizinho, Saudade de Minha Terra - Belmonte & Amaraí, Homem de Pedra - Trio Parada Dura, Canarinho Prisioneiro - Ramoncito Gomes, Saco de Ouro - Mococa & Paraíso, Fio de Cabelo - Chitãozinho & Xororó, As Águas do São Francisco - Gino & Geno, Tô Apaixonado - Teodoro & Sampaio, Moreninha Linda - Tonico & Tinoco e Rio de Lágrimas - Tião Carreiro & Pardinho. É ouvir e embarcar em uma viagem para o interior. Do país e do coração.


CD 1
1. Ainda ontem chorei de saudade - João Mineiro & Marciano
2. Fio de cabelo - Chitãozinho & Xororó
3. As andorinhas - Trio Parada Dura
4. Liguei pra dizer que te amo - Alan e Aladim
5. Panela velha - Sérgio Reis
6. É o amor - Zezé Di Camargo & Luciano
7. Piracicaba - Tonico & Tinoco
8. Rei do gado - Tião Carreiro e Pardinho
9. Boneca cobiçada - Palmeira e Biá
10. Rei da estrada - Campanha & Cuiabano
11. No colo da noite - Zé do Rancho & Zé do Pinho
12. Cavalo preto - Palmeira & Luizinho
13. Pescador e catireiro - Cacique e Pajé
14. Nem dormindo consigo te esquecer - Gian & Giovani
CD 2
1. Estrada da vida - Milionário & José Rico
2. As águas do São Francisco - Gino & Geno
3. Pinga ne mim - Teodoro & Sampaio
4. Majestade, o sabiá - Jair Rodrigues Part. Esp.: Chitãozinho & Xororó
5. Gangorra - Zé Do Rancho & Zé do Pinho
6. Amargurado - Tião Carreiro & Pardinho
7. Cabecinha no ombro Duo Guarujá
8. Esta noite como lembrança - João Mineiro & Marciano
9. Evidências - Chitãozinho & Xororó
10. Canoeiro - Tonico & Tinoco
11. Bica d’água - Iridio e Irineu
12. Beijinho doce - Irmãs Castro
13. Serafim e seus filhos - Ruy Maurity
14. Vide, vida marvada - Rolando Boldrin
CD 3
1. Saudade de minha terra - Belmonte & Amaraí
2. Eu me amarrei - João Paulo & Daniel
3. Capa de revista - Gilberto e Gilmar
4. Entre tapas e beijos - Leandro & Leonardo
5. 60 dias apaixonado - Chitãozinho & Xororó
6. Asa delta (voo livre) - Cézar e Paulinho
7. Homem de pedra - Trio Parada Dura
8. Tô apaixonado - Teodoro & Sampaio
9. A volta do seresteiro - Zilo & Zalo
10. Relógio quebrado - Nestor e Nestorzinho
11. Malvada pinga (Moda da pinga / Marvada pinga) - Inezita Barroso
12. Quero beijar-te as mãos - Irmãs Galvão
13. Boate azul - Joaquim e Manuel
14. Dormi na praça - Bruno & Marrone
CD 4
1. Rio de lágrimas (Rio de Piracicaba) - Tião Carreiro e Pardinho
2. Moreninha linda Tonico & Tinoco
3. O menino da porteira - Luizinho & Limeira
4. Barbaridade Pedro Bento & Zé da Estrada
5. Vida dividida Chrystian & Ralf
6. Adeus Mariana (xote) - Os filhos de Goiás
7. Poeira - Duo Glacial
8. Vou gastar o barão - Gino & Geno
9. Canarinho prisioneiro - Ramoncito Gomes
10. Linda cigana - Silveira & Barrinha
11. Bobeou... A gente pimba - Trio Parada Dura
12. Saco de ouro - Mococa & Paraíso
13. Pingo d’água - Zico e Zeca