=======================================================
Site: http://www.inspirontrance.com/
=======================================================


=======================================================
F B Page: Inspiron Trance
=======================================================


=======================================================
TWITTER : inspiron22
=======================================================	
		


Tracklist:

1. SoundLift - Windmill (Original Mix) [Abora]
2. Andy Blueman - Nyctalopia (Original Mix) [Perceptive]
3. Michael Flint - Hyacinth (Original Mix) [OvertMind]
4. Peet B - Always & Forever (Immersiv Remix) (UpOnly Edit) [Pulsar]
5. Maxima - Finding Freedom (Ledo Remix)  [TFB Records]
6. Vanity In Mind - Midnight Obsession (Nine Gates Remix) [Condura]
7. Kelly Andrew - The Incursion (Epic Orchestral Trance Mix) [Abora]
8. Ahmed Romel - Concordia (Original Mix) (Ori Uplift Flow Edit) [Blue Soho]
9. Ciro Visone - First Coming (Mr Carefull Remix) [Defcon]
10. Oliver V. pres. AirDream 62 - Runaway (Original Mix)  [Silent Shore White]
11. Solarsonic - Inception (Ikerya Project Remix)  [Trance All-Stars]
12. Random X - Deep Silence (Original Mix) [FlyWarp]
13. Matt Chowski - Road to Hill (Original Mix) [Above the Clouds]
14. Etasonic - Part of Me (Original Mix)  [D.MAX]
15. Fierra - From Ashes (Original Mix) [Crystal Source]
16. Conrad Winged & Ascania - Mona Lisa (New World Remix) [Defcon]
17. ID - ID (Andy Elliass Rmx) [Above the Clouds]
18. TechTrek & Myk Bee - Things I Am Not Proud Of (Original Mix) [Redux]


Enjoy
(Inspiron)