Independent Chillout Collection 


 
http://bayimg.com/NaiJbaAeM

Collection of Independent Chill out music 

Pleas note music file format is .ogg for an average user this doesn't mean anything but a power user will be happy, you might need Vlc or strong codec pack K-Lite Codec Pack software is free 

!!!Please support the artists!!!


Music List
________________________________________________________________________

	
01 Approaching Dusk ft. Holly Drummond.ogg	6.3 MB	
01 Mistakes.ogg	5.7 MB	
01 Shining Through The Light Ft. Emily Underhill.ogg	7.6 MB	
02 Disorientated.ogg	6.0 MB	
02 Shining Through The Light Ft. Emily Underhill (Instrumental).ogg	
03 Falling Deeper ft. Emily Underhill.ogg	7.4 MB	
03 Sail.ogg	8.8 MB	
03 Shining Through The Light Ft. Emily Underhill (Cross Them Out Remix) 1.ogg	6.6 MB	
04 From This Day, Until My Last.ogg	8.1 MB	
04 Shining Through The Light Ft. Emily Underhill (Culture Code Remix).ogg	7.8 MB	
05 Where The Rivers Flow.ogg	5.7 MB	
A.N.O. - Regain Hope Part II (We lost It).ogg	5.1 MB	
Aaron Static - Intrepid Journey.ogg	10.6 MB	
Affecting Noise ft. Aiva - One Wish (Original Xmas Mix).ogg	4.8 MB	
Anneka_-_Shut_Her_Down_(Mario_M_Remix).ogg	4.6 MB	
Anth M - Dont wanna be alone.ogg	4.9 MB	1/19/13 
Arrival Of the Birds (Yinyues Remix).ogg	5.1 MB	1/19/13 
Band Of Horses - The Funeral (Sound Remedy Remix).ogg	5.7 MB	
Birdy - Shelter (Owsey Remix New).ogg	7.3 MB	
Birdy - Skinny Love (Owsey Remix).ogg	4.7 MB	
Born.ogg	6.7 MB	1/19/13 2:26:35 AM
Brombaer - Guardian - 01 Guardian of the Sun.ogg	4.9 MB	
Brombaer - Guardian - 02 Guardian of the Moon.ogg	4.3 MB	
CMA - Broken Thoughts (Full Version).ogg	9.1 MB	
CMA - The Streets (Chillstep).ogg	6.2 MB	
CMA & Kaj. - DayDream (Full Version).ogg	9.1 MB	
CMA & Sacred - In Motion.ogg	6.2 MB	
Cover HQ.jpg	6.5 MB	
Cover LQ.jpg	5.7 MB	
Crush & NYD - Fall to Pieces.ogg	8.8 MB	
Desires ft. Jillian Aversa.ogg	7.0 MB	
Dub-eden - Discovery.ogg	7.9 MB	
Ellie Goudling - Hanging On (Pulse O.ogg	4.6 MB	
Ellie Goulding - Guns & Horses (Crush & NYD Remix).ogg	7.4 MB	
emilly underhill - another place [Poolz Remix].ogg	9.5 MB	
Everest - Enchant (Orignal Mix).ogg	7.6 MB	
Fake Static Noise - Late Night.ogg	8.2 MB	
Fake Static Noise - Through My Heart.ogg	7.1 MB	
Fracture Design - A Winter's Tale (Free Tune).ogg	10.1 MB	
Freak - Hollow Notes.ogg	3.8 MB	
Freak - Surface of Universe.ogg	4.6 MB	
Freak - We Deserve To Die.ogg	4.4 MB	
Future Skyline - Late Winter Storms.ogg	10.2 MB	
Gange-a-Midi - You Appear (Final Mix).ogg	5.7 MB	
Hans Zimmer - Time (Soular Order Remix).ogg	6.9 MB	
Heart of Courage (A.N.O. Remix).ogg	4.4 MB	
Hike - Homeworld.ogg	7.4 MB	
I had a dream final master.ogg	7.2 MB	
Infectiouz - Breathe.ogg	4.6 MB	
JacM_-_Just.ogg	5.6 MB	
Just For Now (OZZIE x Hucci Remix).ogg	3.0 MB	
kannamix_feat._coma_-_wouldn_t_it_be_good.ogg	6.0 MB	
Klrx & Kaj.- Empathy.ogg	6.8 MB	
Koda - Glass Veil (CoMa Remix).ogg	6.7 MB	
Koda_-_In_the_Deserts_of_La_Femme_Period_Chaser_(JacM_Remix).ogg	5.9 MB	
Lexis - In Sleep EP - 01 Aquarell.ogg	7.8 MB	
Lexis - In Sleep EP - 02 White Crown.ogg	5.7 MB	
Lights - Siberia (5vel Remix).ogg	11.1 MB	
Meiko - Leave the Lights On (Bronze Whale Remix) Remaster-3.ogg	5.3 MB	
Melodiam Somnia.ogg	4.6 MB	
Memory.ogg	6.4 MB	
Mimi Page - Lullaby For The Lonely (Yinyues Remix).ogg	3.8 MB	
Neutralize - Where You Should Be (Ft. Nori).ogg	6.9 MB	
nExow - Sweetheart EP - 01 Sweetheart.ogg	6.5 MB	
nExow - Sweetheart EP - 02 Extraordinary Thing.ogg	7.3 MB	
nExow - Sweetheart EP - 03 The Other Side.ogg	6.0 MB	
Nhumo_Waiting For Heaven.ogg	9.3 MB	
Nirvana-Somefthing-In-The-Way-Biscope-Boot.ogg	6.0 MB	
Offer Nissim Feat Maya - Illusion [Full Club Mix].ogg	11.5 MB	
One love remastered.ogg	6.7 MB	
Owsey & Resotone - You're Lost, You're Alone.ogg	6.5 MB	
Rimshox - Walking My Own Path.ogg	5.7 MB	
Robert Miles - Children (electus remix).ogg	6.9 MB	
Seven Lions - Days To Come (Electus Remix) 2.ogg	5.3 MB	
Silhouette.ogg	5.8 MB	
Skream - Perferated (Creepa Remix).ogg	5.4 MB	
Soldiers.ogg	6.2 MB	
Subcode - Endless.ogg	6.0 MB	
Synthetic Epiphany ft CoMa - Volition (1).ogg	7.3 MB	
The Weeknd - Rolling Stone (Truth Remix)(2).ogg	6.9 MB	
The XX - Angels (OdyC Remix) +80.ogg	5.0 MB	
TIGERjunes - love over hate, evertime.ogg	4.3 MB	
Time To Go.ogg	5.7 MB	
Tomorrow - Kasbo.ogg	7.3 MB	
Turn It Down (A.N.O. Remix).ogg	5.7 MB	
Twenty Eight (Ianborg & Bronze Whale Bootleg).ogg	8.2 MB	
William Fitzsimmons & Priscilla Ahn - I Don't Feel It Anymore (JacM Chillstep Remix).ogg	6.8 MB	
Windfalls.ogg	7.5 MB	
Wobzor - Further away.ogg	4.6 MB	
Zedd Feat. Matthew Koma - Spectrum.ogg	5.7 MB	

____________________________________________________________

Studio76
ONLY HIGH QUALITY RELEASES
Sharing is caring
[b]!!!If you like it, buy it!!![/b]
follow on twitter
/Studio76HD
please visit also:
My internet speed 
60+mbps
		