320k MP3 For high quality audio

all tagged correctly and album art is there.


Smell that? ThatΓÇÖs the sweet smell of democracy, a scent breathed in deep by more people than ever this year, in triple jΓÇÖs biggest Hottest 100 to date. From its humble beginnings 20 years ago, the triple j Hottest 100 has grown to become the largest musical countdown in the known world.  1,516,765 votes were cast, thatΓÇÖs bigger than the population of Guinea-Bissau, and we all know how much they treasure democracy.

Track Listing
Disc 1:
Macklemore & Ryan Lewis - Thrift Shop (ft. Wanz)
Flume - Holdin On
The Rubens - My Gun
alt-J - Breezeblocks
Frank Ocean - Lost
Florence + The Machine - Spectrum (Say My Name) (Calvin Harris Remix)
Loon Lake - Cherry Lips
The Black Keys - Gold On The Ceiling
Major Lazer - Get Free (ft. Amber Coffman)
Chet Faker - I'm Into You
The xx - Angels
Seth Sentry - Dear Science
Django Django - Default
Miike Snow - Paddling Out
Parachute Youth - CanΓÇÖt Get Better Than This
Ball Park Music - Coming Down
MS MR - Hurricane
Skrillex - Bangarang (ft. Sirah)
Birds Of Tokyo - This Fire
Two Door Cinema Club - Sun
Alpine - Gasoline

Disc 2:
Of Monsters & Men - Little Talks
Tame Impala - Elephant
Icona Pop - I Love It (ft. Charli XCX)
360 - Run Alone
The Temper Trap - Trembling Hands
Disclosure - Latch (ft. Sam Smith)
Rudimental - Not Giving In (ft. John Newman & Alex Clare)
Mumford & Sons - I Will Wait
Grimes - Oblivion
Asta - My Heart Is On Fire
Totally Enormous Extinct Dinosaurs - Household Goods
San Cisco - Fred Astaire
Chance Waters - Young And Dumb (ft. Bertie Blackman)
Hermitude - HyperParadise (Flume Remix)
Feed Me & Crystal Fighters - Love Is All I Got
Everything Everything - Cough Cough
Alabama Shakes - Hold On
Sticky Fingers - Caress Your Soul
Bat For Lashes - Laura
Flight Facilities - Clair De Lune (ft. Christine Hoberg)