

AZMANiAN'S REAL TRAP SHiT VOL.2


TRACKLiST:
12th Planet & Mayhem (ft. Pennybirdrabbit) - Murdaaa.mp3
BANKS - Fall Over (Djemba Djemba Remix).mp3
Bablyon (Oh Snap!! 'Trap Go Hard' Mix).mp3
Birdy Nam Nam - Goin' In (Skrillex Goin' Down Mix).mp3
Brillz - DÃ©ja Vu.mp3
Chief Keef - Love Sosa (RL Grime Remix).mp3
ETC!ETC! & Brillz & Diplo - Bueller (ft. Chuck Inglish).mp3
Flosstradamus & DJ Sliink - Crowd Ctrl.mp3
Flume - Left Alone feat. Chet Faker (Ta-ku Remix).mp3
Gent & Jawns - COCO.mp3
Hucci x GameFace - The Leaves Are Brown.mp3
Infuze - Get Enough.mp3
Jah No Partial (Yellow Claw & Yung Felix Remix).mp3
Just Blaze x Baauer - Higher.mp3
KAYTANDRA - Down Low (Featuring Green Hypnotic & Kaytranada).mp3
Knife Party - Internet Friends (heRobusts Run Da Trap Bootleg).mp3
LOUDPVCK - NV$TY.mp3
MIA - Boys (gLAdiator Remix).mp3
Miguel - Do You... (Cashmere Cat Remix).mp3
Notixx - LEAN.mp3
Rihanna - Stay (Branchez Bootleg).mp3
Salva & Brenmar - LET ME BANG.mp3
Salva - Drop That B.mp3
Tinashe - Boss (Ryan Hemsworth Remix).mp3
Wynter Gordon - Dirty Talk (Party Favor_s Festival Trap Fix).mp3
heRobust - Turn Ape.mp3


EVERYTHiNG iS bLESS * KING JULIEN XIII THA ORIGINAL DON * 

SHOUTOUTS TO JELLOSEA, AUDiOMiMiC, 3RDWORLDRECORDS, TOUCHMYBODY, RUNTHATRAP
STAY TUNED FOR MORE DON'T TOUCH THAT DiAL