BUSTY ANAL - MANDY MAY -  I Got The Biggest Tits 3

Mandy May [Anal Facial A2M IR]


I Got The Biggest Tits! Wet T-shirt Contest 3 (2003) Evasive Angles

Scene 5. Mandy May, Darren James



MANDY MAY

Performer AKA 	Mandy, Iva Klein, Iva, Lora, Melons, Iva Kleinova (websites)
Birthday	July 23, 1983
Astrology	Leo 
Birthplace	Czech Republic 
Years Active	2003-2008 (Started around 20 years old)
Ethnicity	Caucasian
Nationality/Heritage	Czech
Hair Colors	Brown/Auburn
Measurements	38DD-27-37
Height	5 feet, 3 inches (160 cm)
Weight	125 lbs (57 kg)
Tattoos	Tribal design on lower back
Non-Ear Piercings	Navel; Nostril; Tongue
Comments	There are no comments for this performer.
Website	No data