Come on PEOPLE...  If you hit and run, which by the way over 70% did on Vol 1 - Guess what?  I have to seed longer and longer until I am sure the torrent is 'safe' from not having me as the primary seed.

YOU ALL KNOW how this works and SHAME on you for hitting and running.  SEED for at least 24 hours or a 1 to 1 Ratio.   These are LARGE downloads, DVDx2 or 7 Gigabytes or more in size.

If you hit and run, then you just make everyone else upset and of course delay me releasing the 2nd of FOUR volumes in this series.

Your CALL... Hit and Run and wait a month or MORE for the other 3 albums - or be a nice person and give back to the swarm the same amount you have downloaded from it.

YOUR CALL!

VOB (MPEG2) format from DVD, mostly LOGO free but some VH1 (sorry).  Thank you to the original seed on Demonoid.   Tagged and good to go on any playout system.  4:3 Ratio.
Sound 320bps.

Aerosmith - Cryin [Video].VOB
Alice Cooper - It's Me [Video].VOB
Bon Jovi - I'll Be There For You [Video].VOB
Cinderella - Heartbreak Station [Video].VOB
Def Leppard - Have You Ever Needed Someone So Bad [Video].VOB
Europe - Carrie [Video].VOB
Faster Pussycat - House Of Pain [Video].VOB
FireHouse - I Live My Life For You [Video].VOB
Guns 'N' Roses - November Rain [Video].VOB
Keel - Tears Of Fire [Video].VOB
Kiss - Forever [Video].VOB
Kix - Don't Close Your [Video].VOB
Mister Big - To Be With You [Video].VOB
Ozzy Osbourne & Lita Ford - Close My Eyes Forever [Video].VOB
Poison - I Won't Forget You [Video].VOB
Queensryche - Silent Lucidity [Video].VOB
Scorpions - Holiday [Video].VOB
Skid Row - I Remember You [Video].VOB
Tesla - What You Give [Video].VOB
Tyketto - Standing Alone [Video].VOB
Warrant - Heaven [Video].VOB
Wasp - Hold On To My Heart [Video].VOB
Whitesnake - The Deeper The Love [Video].VOB
Winger - Headed For A Heartbreak [Video].VOB

Enjoy the music OH and those waiting for me to re start previous torrents?  Well until I get this lot out of the way my upload bandwidth is maxed out.  So faster you all give back to the swarm, the faster I can move on.   I use SUPER SEEDING.  If you have no idea what that is then LEARN.. and do it FAST.   Ignorance is NO EXCUSE for a Pirate Bay user!!!!!!!!!!!!!!!!

Rigmar Radio - Rockin' the Free World since 1967