Claude VonStroke & Justin Martin - The Essential Selection (21-12-2012)

Bit rate: 224 kbps
Sampling rate: 48 kHz


Tracklist:
The Martin Brothers - Stoopit [Dirtybird]
Krywolf & Claude Von Stroke - Turbosteppa [Dirtybird]
Hannah Wants - Dappy [Food]
DJ Glen - Boogie Manifesto [Beat Division]
Justin Martin & Claude Vonstroke - Beat That Bird [dirtybird]
Eats Everything - Entrance Song [Pets Recordings]
Ejeca - Would I Lie [Extended Play]
L B Lynam - Get Things Straight [White]
Justin Martin & Eats Everything - Feather Fight [White]
Ultraista - Small Talk (Four Tet Remix) (Justin Martin Rework) [I Am Fortified]
The xx - Shelter (Justin Martin rework) [White Label]
Justin Martin & Eats Everything - Harpy [Hypercolour]
Justin Martin - Ruff Stuff (Eats Everything ReRuff) [Dirtybird]
Dean Martin - Let It Snow (Tom Flynn Rework) [Unknown]
KiNK Vs. Marc Romboy - Pump It! [Systematic]
The Roger Wagner Chorale - Carol Of The Bells [Unknown]
Eltron John - Bomby [White Label]
Maribou State & Pedestrian - Mask [Southern Fried]
Catz N Dogz - They Frontin [Get Physical]
Justin Martin & Leeroy Peppers - Riding Spaceships (Shadowchild Remix) [Dirtybird]
Run Dmc - Christmas In Hollis [Arista Records]
Unknown 52 - New #52 [White Label]
The Pull - Friend Within [Dirtybird]
Starkey - Command (Noisses Remix) [Civil Music]
Justin Martin - Ghettos & Gardens (Claude Von Stroke Mix) [Dirtybird]
Breach - Let's Get Hot [White Label]
Ryhthm Sticks - SCNTST [Boysnoize Records]
James Brown - Please Come Home For Christmas [Universal]