                      Jornada Mundial da Juventude - Rio 2013

                                 BOTE FÉ BRASIL

DESCRIÇÃO

Os maiores nomes da música católica reunidos em um emocionante evento que marca a peregrinação da cruz no Brasil. Este é o projeto Bote Fé Brasil, um registro histórico, que apresenta mais de 30 representantes da música católica reunidos, pela primeira vez, em um show que emocionou milhares de pessoas. Gravado em Natal, no Rio Grande do Norte, nos dias 6 e 7 de fevereiro de 2012,  o Bote Fé Brasil celebra a peregrinação da cruz pelo mundo e faz parte da JMJ – Jornada Mundial da Juventude, que culmina na vinda do Papa Francisco ao Brasil em julho de 2013.

Bote Fé Brasil é o DVD oficial da JMJ Rio 2013, possui grande apelo com os jovens de todo o país. Seu diferencial é trazer no repertório ao vivo o hino oficial da JMJ Rio 2013 “ Esperança do Amanhecer” e novas versões de canções já conhecidas, interpretadas por grandes nomes como Padre Marcelo Rossi, Padre Fábio de Melo, Padre Zezinho, Padre Antônio Maria, Eugenio Jorge, Rosa de Saron, Ministério Adoração e Vida, Banda Dominus, Padre Reginaldo Manzotti e muitos outros. Para o pré lançamento do DVD, foi exibido um vídeo com os melhores momentos do projeto na feira EXPOCatólica, um evento 100% voltado para o público  religioso que aconteceu  no início de julho, em São Paulo, e contou com cerca de 50 mil visitantes. Trechos do DVD também foram exibidos no evento da escolha do hino da JMJ no Maracanãzinho (RJ). Intitulado “O Maior Encontro da Música Católica no Brasil”, o DVD Bote Fé Brasil é capaz de emocionar e envolver o público nessa contagiante propagação do movimento católico no país. 

MÚSICAS


1) Um Certo Galileu (Ao Vivo) - Padre Zezinho, Scj, Cantores De Deus

2) Glória E Majestade (Ao Vivo) - Adriana Arydes

3) Coragem (Ao Vivo) - Cantores De Deus, Bruno Camurate

4) Anjos De Deus (Ao Vivo) - Pe. Marcelo Rossi

5) Força E Vitória (Ao Vivo) - Eliana Ribeiro

6) Utopia (Ao Vivo) - Zé Vicente, Padre Joãozinho

7) Emanuel - Eugênio Jorge, Celina Borges, Suely Façanha, Ziza Fernandes, Luiz Carvalho

O Coração Do Homem (Ao Vivo) - Walmir Alencar, Padre Fábio De Melo, Adriana Arydes, Ziza Fernandes, Guilherme Sá, Davidson Silva

9) Nunca Pare De Sonhar (Ao Vivo) - Pe. Fábio De Melo

10) Chuva De Graça (Ao Vivo) - Eros Biondini

11) Estrangeiro Aqui (Ao Vivo) - Missionário Shalom

12) Tentação (Ao Vivo) - Irmã Kelly Patrícia

13) Com Tua Mão (Ao Vivo) - Suely Façanha,Davidson Silva

14) Nossa Senhora (Ao Vivo) - Padre Antônio Maria

15) O Céu Está Rezando Por Ti (Ao Vivo) - Anjos De Resgate

16) Renda-Se (Ao Vivo) - Ministério Adoração E Vida

17) Abraço De Pai (Ao Vivo) - Ministério Adoração E Vida

18 ) Sonda-Me (Ao Vivo) - Padre Reginaldo Manzotti

19) Com Jesus É Festa (Ao Vivo) - Dominus

20) Sem Você  (Ao Vivo) - Rosa De Saron

21) Do Alto Da Pedra (Ao Vivo) - Rosa De Saron


FICHA TÉCNICA

Título Original: Bote Fé Brasil - JMJ RIO 2013
Editora: Sony Music
Gênero:  Show
Data de Lançamento: 2013.
Tempo de Duração: 1 hora e 54 minutos + Extras.
Formato dos Arquivos: .ISO.
Resolução: 720X480 pixels.
Formato da Tela: 4:3
Video Codec:  MPEG2 Video.
Audio Codec: Dolby AC3 48000Hz stereo 192kbps.
Idioma: Português
Legenda: Português, Italiano, Espanhol, Inglês

Qualidade do Vídeo: DVD-R.

Método de Compressão: DVD Rebuilder + Canupus Procoder 3



RELEASE: BOTEFE.DVDR.BY.THECROW


Retirado do site: trader.speed-share.org
				