Susie Sorrento (as Stella) [Anal Facial IR]

Sweet Teens and Black Cocks 1 (2003)

Scene 5. Susie Sorrento, Joachim Kessef, Mark Anthony


Susie Sorrento 
Performer AKA 	Akropolis, Akropolisz, Andrea, Andrea ButjkoBetty, Jenny Jordan, Stella, Susie, Suzy, Suzy Soreento
Birthday	June 29, 1982
Astrology	Cancer 
Birthplace	Hungary 
Years Active	2001-2008 (Started around 19 years old)
Ethnicity	Caucasian
Nationality/Heritage	Hungarian
Hair Colors	Black/Brown/Dark Brown
Measurements	36C-23-34
Height	5 feet, 3 inches (160 cm)
Weight	No data
Tattoos	No data
Non-Ear Piercings	Navel
Comments	There are no comments for this performer.
Website	No data
 
http://bayimg.com/cAliaAaEJ