16 Bit Lolitas - Deep Space Girls (Davi Remix) (Cut From Blake Set)-enTc.mp3
ACS Project - It's Impossible (Cj Peeton 2012 Mix) (Cut From Kenji Set)-enTc.mp3
Aerotek feat. Anji Bee - My Lonely Sunset (Dub Mix) (Cut From Aurosonic Set)-enTc.mp3
Airscape - Intensive (ASOT 613 Rip)-enTc.mp3
Ana Criado & Omnia - No One Home (Fon.Leman Remix) (Cut From Ronde Set)-enTc.mp3
Andrea Sobato - Chances (Cut From Ronde Set)-enTc.mp3
Andy Tau - Fable (ASOT 613 Rip)-enTc.mp3
Araya & Mark Dreamer - Tension (New World Remix) (Cut From Romel Set)-enTc.mp3
Ariel & Danilo - Legology (Cut From Andi Set)-enTc.mp3
Ariel Ortega - Aphelium (David Mayne Remix) (GDJB Rip)-enTc.mp3
Arisen Flame - Challenger (ASOT 613 Rip)-enTc.mp3
Ashley Wallbridge - Vision (Juventa Remix) (ASOT 613 Rip)-enTc.mp3
Basil O'Glue - Gilgamesh (Cut From Basil Set)-enTc.mp3
Beat Service - Metro (Digital X Remix) (GDJB Rip)-enTc.mp3
Ben Gold - Amplified (Remix) (-SHORT- ASOT 613 Rip)-enTc.mp3
Chris Schweizer - Reflections (Original Mix) (-SHORT- ASOT 613 Rip)-enTc.mp3
Danny Stubbs - They Walk Among Us (Thomas Datt Remix) (GDJB Rip)-enTc.mp3
Deathmind & Estigma - Time Traveller (Riot Mix) (Cut From Estigma Set)-enTc.mp3
Dreamy - Amphora (Jimmy Chou Remix) (Cut From Romel Set)-enTc.mp3
Giuseppe Ottaviani & Ferry Corsten - Magenta (-LivE- Cut From Ferry Set)-enTc.mp3
Hazem Beltagui - Eclipse (ASOT 613 Rip)-enTc.mp3
In Progress - Andromeda (Erick Strong Remix) (Cut From Aurosonic Set)-enTc.mp3
Johlin - The Fang (Original Mix) (GDJB Rip)-enTc.mp3
Josh Abrams - Dark Night (Exoplanet Remix) (Cut From Basil Set)-enTc.mp3
Koko B feat. Anthya - Unconditional Love (Cut From Masoud Set)-enTc.mp3
Lana Del Rey - Young & Beautiful (Marcus Schossow Summer Remix) (GDJB Rip)-enTc.mp3
Late Night Alumni - Sapphire (Cosmic Gate Remix) (GDJB Rip)-enTc.mp3
Markus Schulz - UNTITLED (-LivE- Cut From Ferry Set)-enTc.mp3
Marsbeing - Yesterday, Today, Tomorrow (Sezer Uysal Remix) (Cut From Ronde Set)-enTc.mp3
Martin Graff - Nevermourn (Cut From Ronde Set)-enTc.mp3
Matao - Perfectro (Charlie May Remix) (Cut From Basil Set)-enTc.mp3
Matt Davey Featuring Kate Dowman - Sunrise (Here I Am) (GDJB Rip)-enTc.mp3
me2u - Balearia (Cut From Aurosonic Set)-enTc.mp3
MUUI - Rewind (Original Mix) (Cut From Kenji Set)-enTc.mp3
Napalm & D-Phrag - Xanadu (Cut From Basil Set)-enTc.mp3
Pavel Yudin - Sweet (Original Mix) (Cut From Romel Set)-enTc.mp3
Rene Ablaze Featuring Jacinta - You're My Destination (Wellenrausch's Dark Matter Remix) (GDJB Rip)-enTc.mp3
ReOrder - Last Moments In Paradise (Dmitry Golban Remix) (Cut From Aurosonic Set)-enTc.mp3
SoundGate & Max Solar - Cold Day (Estigma Remix) (Cut From Estigma Set)-enTc.mp3
Stevy Forello - Black Sunlight (Artra & Holland Remix) (ASOT 613 Rip)-enTc.mp3
Timur Shafiev feat. Irage - Faith (Cut From Ronde Set)-enTc.mp3
Tom8 vs. Luke Ryan - Sunstar (GDJB Rip)-enTc.mp3
Transet - Dance (Cut From Aurosonic Set)-enTc.mp3
Two & One feat. Jess Morgan - Reasons Later (Cut From Ronde Set)-enTc.mp3
Vaivo - From North To South (Cut From Ronde Set)-enTc.mp3
Wach & AYDA - Opena (ASOT 613 Rip)-enTc.mp3
Zetandel & Irina Makosh Present Ineya - My Lonely Night (Cut From Ronde Set)-enTc.mp3
