 Artista: VA

 Titulo: Pack Temazos Primavera 2013 (2CD)

 Genero: Pop, Latino, Dance

 Formato: Mp3

 Tamaño: 512 Mb

 Bitrate: VBR

 Año: 2013

 Temas:

 CD1

 Albert Novo Feat C Milo - Mi Angel

 Alex Corvo Jey Lemes - Que tengo que hacer

 Cosmik - Ella (Guade Edit)

 Dj Federato Ft Xavi Rodman - Mas de lo mismo (Extended)

 DJ Km Albert Da Costa Ft Valentin Top´s - Piel De Caramelo

 Dj Rajobos Dj Nev Feat Isaac Leon - Sexy (Radio Edit)

 Drago´n Rojo & Robert Taylor - Tu Compan~ia (Dj Nev Remix )

 Dyland & Lenny - Mas No Puedo Amarte (Xemi Canovas & Javi Garcia Remix)

 Eddy Herrera - La Vida Loca

 Estilo Libre Feat Albert Fernandez - Linda Morena (Extended Version)

 Farruko Ft K4G - Today Is My Day

 Grupo Extra Feat MDS - Beautiful Girl

 Isaac Leon - Eres Tan Bonita Prodz Mr Rommel

 Jay Santos - Caliente (Extended Mix)

 Jayko - Mueve Mueve (PABLO MORA PRIVATE REMIX)

 Julgo Inma Bernal - Alas Pa` Volar (Original)

 Kaleh - Hasta Que Caiga El Sol ( Prod MrRommel )

 Kike Rodriguez - Cuando Me Amabas

 Kiko Rivera ft. Dr. Bellido - Chica Loca (Jay Herre & Javi Calzada Remix)

 KIKS SER BROWN - Por Un Beso (Prod Wini Dominguez Cristian Duplay)

 Los Locos vs Mariucch & El 3mendo - La Ola (Radio Edit)

 Maluca - El Tigerazo (Lo Tengo Todo Papi) [Mr. Rommel Remix]

 Marco Hinojosa Feat El Calle Latina - Fin De Semana (Kato Jime´nez Jesu´s Sa´nchez Remix)

 Albert Novo Ft Latin Fusion C Milo - Quisiera Sentir (Kilian Dominguez Jm Castillo Remix)

 Mc Dues - Todo Mi Corazon (PROD. KAIZER)

 MDS - My Lady (Prod Javier Declara & Mr Rommel)

 Miguel Saez - La Cazadora

 Neon El Emperador - Ta Ki Ta (Rajobos & Nev Remix)

 Nevolution Feat Fuego - Una Noche

 Tony Fernandez & Adrian Ramos Ft. Nico Mastre - Ole Ole (Extended Mix)

 Yero Flow Feat Juan Martinez - Niña Bonita

 Yisu Music - Somos Amigos

 CD2

 Akon - That Na Na (Dany Lorence Remix)

 Albert Kick feat Jason Rene - Black (From The Waist Down) (Radio Edit)

 Dane Rumble - Cruel (Albert Kick Jordi MB Remix)

 Diabolik - The Body Rock (Original Mix)

 Dj Antoine vs. Mad Mark - Broadway (Dj Antoine vs. Mad Mark 2K12 Radio Mix)

 Geo Da Silva & Jack Mazzoni - Booma Yee (Radio Edit)

 Guena LG feat. Gravitonas - Brighter (Radio Edit)

 Hook N Sling vs Nervo - Reason (Vicetone Remix) [Radio Edit]

 Jack Holiday feat. Patrick Miller - Real Love (Radio Mix)

 JL, Afterman - Blue (Da Ba Dee) (Club Mix)

 Johan K-Higher emotions (radio mix)

 Julian The Angel Feat McLevit Ashela - Bad Girl

 Katy Perry ft Mike Candys Jack Holiday - ET Children NEW REMIX

 Mike Candys feat. Evelyn & Carlprit - Brand New Day (Original Mix)

 Mike-D feat. Nensi - Lie To Me (Club Mix)

 Modana & Carlprit - Your Biggest Fan (Radio Edit)

 Noise Nation Ft. Cato - We Don t Care (Radio Edit)

 Pitbull Christina Aguilera - Feel This Moment (Ibiza Remix 2013)

 R.I.O. - Living In Stereo (Money G Radio Edit)

 Rawanne feat Toni Tonini - Millionaire (Dj Sequence and Wave Rocket Remix)

 Sean Paul - She Doesn t Mind (Dj Nitkin Mashup 2013)

 Spencer & Hill - Dead Or Alive (Radio Edit)

 SWEETDRUMS FEAT ALICIA KEYS - GIRLS ON FIRE (2K13 PRIVATE REMIX)

 Tacata vs icemc (Kike Rodriguez Private mashup)

 Turbotronic - Hey Girl (Radio Edit)

 WHIGFIELD FEAT CARLPRIT - Saturday Night

 YarosLOVE - Just Be There