CD1

    Jorge Palma - Encosta-Te a Mim
    Pedro Abrunhosa & Os Bandemónio - Se Eu Fosse um Dia o Teu Olhar
    Delfins - Saber Amar
    André Sardet - Foi Feitiço
    Rui Veloso - A Paixão (Segundo Nicolau da Viola)
    Susana Félix - Mais Olhos Que Barriga
    The Gift - Fácil de Entender
    4Taste - Só Tu Podes Alcançar
    Santos & Pecadores - Fala-me de Amor
    Tony Carreira - É Melhor (Dizer Adeus)
    Mafalda Veiga - Estrada
    Paulo Carvalho & Rita Guerra - O Meu Mundo Inteiro
    D'ZRT - Feeling
    José Cid - + 1 Dia
    Adelaide Ferreira - Papel Principal
    Paulo Gonzo & Lúcia Moniz - Leve Beijo Triste
    Per7ume - Intervalo
    FF - Tudo o Que Quero (Acústico)

CD 2:

01. Paulo Gonzo - Dei-te Quase Tudo
02. João Pedro Pais - Não Há (Ninguém Como Tu)
03. Luís Represas - Mar I Ana
04. Os Azeitonas - Anda Comigo Ver Os Aviões
05. Heróis do Mar - Paixão
06. Expensive Soul - O Amor é Mágico
07. Três Tristes Tigres - O Mundo a Meus Pés
08. Diana Basto - Grita, Sente
09. João Portugal - Foste Tu
10. Rita Guerra - Chegar a Ti
11. Pedro Khima - Esfera
12. Marta Plantier - Remédio Santo (Para Mim)
13. Beto - Tudo por Amor
14. Rita Pereira - Doce Fugitiva
15. Além Mar - Deixa-me Amar
16. Just Girls - A Vida Te Espera
17. Berg - Morangos Com Açúcar

    Nos últimos anos, a TVI tornou-se um veículo de excelência para difusão da música portuguesa, incutindo nos espectadores uma maior proximidade com aquilo que se cria musicalmente no País.

    É por isso natural que este duplo CD reflita o melhor da música Portuguesa dos últimos 20 anos, com nomes incontornáveis como Rui Veloso, Jorge Palma, Delfins, ou Tony Carreira.