

ARTIST: DJ RECTANGLE FEAT. DJ SALLY
 ALBUM: WHEN WORLDS COLLIDE
 YEAR: 2013
 
TRACKLIST:
 INTRO - DJ RECTANGLE
 TITANIUM RELOADED - DAVID GUETTA / SIA / DJ RECTANGLE
 CRAZY ILL SCRATCH - DJ CRIME
 GET UP (RATTLE) - BINGO PLAYERS FT. FAR EAST MOVEMENT
 EVERYDAY IS YOUR BIRTHDAY - SWIZZ BEATS / CHRIS BROWN/ LUDACRIS
 GANGNAM STYLE - PSY
 SCREAM - USHER
 GRAND MASTER SLAP SCRATCH - DJ RECTANGLE
 THIS IS LOVE - WILL I.AM / EVA SIMMONS
 JUICY - NOTORIOUS B.I.G.
 GOIN' IN - J-LO / FLORIDA / LIL JON
 DRAGON SCRATCH - DJ SALLY
 LET'S GO - CALVIN HARRIS / NE-YO
 DEADLY NEEDLY SCRATCH - DJ RECTANGLE
 SEXY & I KNOW IT - LMFAO
 I GOT A HANGOVER - TAIO CRUZ
 WHERE HAVE YOU BEEN - RIHANNA
 MERCY (RMX) - KANYE WEST / BIG SEAN / PUSHA T / 2 CHAINZ
 WHISTLE (RMX) - FLORIDA / DJ RECTANGLE
 NO LIE (RMX) - DRAKE / DJ RECTANGLE
 SUICIDE SCRATCH - DJ RECTANGLE
 TOUCH THE SKY - SEAN PAUL
 CA$HIN' OUT - CA$H OUT
 GOOD FEELING - FLORIDA / AVICII
 LIGHTNING LIZARD CLAW SCRATCH - DJ RECTANGLE
 SIDEWAYS SACRED CHIA PET SCRATCH - DJ BAMBU 
BOOM BOOM POW - BLACK EYED PEAS
 RACK CITY - TYGA
 BASS DOWN LOW - DJ SALLY RMX - CATARACS / DEV
 WITH MY HANDS UP - LIL' JON
 THE MOTTO - DRAKE
 MARVIN GAYE & CHARDONNAY - BIG SEAN / KANYE WEST
 TALKING HAND SCRATCH - DJ RECTANGLE
 SWIMMING POOLS - KENDRICK LAMAR
 SHOTS - LMFAO
 DRUNKEN MASTER SCRATCH - DJ RECTANGLE
 MR. SAXOBEAT - ALEXANDRA STAN
 HOTEL ROOM - PITBULL
 DRINKING FROM THE BOTTLE - CALVIN HARRIS / TINIE TEMPAH
 ALCOHOL - THE CATARACS / SKY BLU
 RIGHT NOW - RIHANNA / DAVID GUETTA
 DEADLY KIWI SCRATCHES PT 1& 2 - DJ RAW
 DYNAMITE - TAIO CRUZ
 DIE YOUNG - KE$HA
 LAST NIGHT - PITBULL
 BANDZ A MAKE HER DANCE - JUICY J / LIL WAYNE / 2 CHAINZ
 SCHIZOPHRENIC SHISH KABOB SCRATCH - DJ RECTANGLE
 CALL ME MAYBE - CARLY RAE JEPSON
 NIGGERS IN PARIS - JAY-Z / KANYE WEST
 FEEL SO CLOSE - CALVIN HARRIS
 DRANK IN MY CUP - KIRKO BANGZ / J. COLE
 FOR THE REST OF MY LIFE - USHER / LUDACRIS
 PARTY CRASHER SCRATCH - DJ MICHAEL TOAST
 DIAMONDS - RIHANNA
 YOUTANG CLAN CUTZ - DJ BAMBU
 MAKE THE CROWD GO - ALVARO
 MOVES LIKE JAGGER - MAROON 5
 HELL YEAH - KURD MAVERICK
 CURSED TURNTABLE SCRATCH - DJ RECTANGLE
 STARSHIPS - NICKI MINAJ 
GIRL ON FIRE - ALICIA KEYS
 CAT FIGHT SCRATCH - DJ MIKA GOLD
 DON'T STOP THE PARTY - PITBULL
 SCREAM & SHOUT - WILL I.AM /BRITTANY SPEARS
 SHORT DICK MAN - 20 FINGERS / GILLETTE
 GIVE ME EVERYTHING - PITBULL / NEYO
 HEY - 3OH!3 LIL JON
 WELCOME TO ST. TROPEZ - DJ ANTOINE
 DON'T WAKE ME UP - CHRIS BROWN
 CROUCHING ELEPHANT SCRATCH - DJ JOEY MAZZOLA 
PON DE FLOOR - MAJOR LAZOR
 SWEDISH MEATBALL SCRATCH - DJ RECTANGLE
 DON'T YOU WORRY CHILD - SWEDISH HOUSE MAFIA
 CLIQUE - KANYE WEST / BIG SEAN / JAY=Z
 TONIGHT - ENRIQUE IGLESIAS / LUDACRIS
 THE LUCKY ONES - KERLI
 WHAT'S MY NAME - SNOOP DOGGY DOGG
 PUTT THAT A$$ TO WORK - LMFAO
 CHECK IT OUT - BEASTIE BOYZ
 POP BOTTLES - SKY BLU
 BIRTHDAY SONG - 2 CHAINZ / KANYE WEST
 PAYPHONE - MAROON 5
 FRESH & FURIOUS SCRATCH - DJ J-CUE
 WHAT HAPPENS IN VEGAS - CHUCKIE / GREGOR SALTO
 ASS N' TITTIES - DJ ASSAULT
 SIX MILLION DOLLAR HAND SCRATCH - DJ RECTANGLE
 GANGNAM BREAK - FATMAN SCOOP / DJ KASSANOVA
 SOUTHPAW CHIHUAHUA SCRATCH - DJ CHONZ
 LOCKED OUT OF HEAVEN - BRUNO MARS
 WARPED NEEDLE SCRATCH - DJ PREMIER
 LOVE ME (GOOD KUSH N ALCOHOL) RMX - LIL WAYNE / DJ RECTANGLE
 BROKEN TURNTABLE SCRATCH - DJ RHFACTOR
 BRING OUT THE BOTTLES - RED FOO
 DIRTY BOYFRIEND (BAD MF RMX) - JUSTIN BEIBER / LIL JON
 FEEL THIS MOMENT - PITBULL / CHRISTINA AGUILERA
 FEEL THIS SCRATCH - DJ SPINDERELLA
 CAN'T GET ENOUGH - J. COLE
 HARLEM SHAKE - BAAUER 


