Artista: VA
Titulo: VA - Romantic and Lyrics Vol 2 (2013)
Estilo: Pop
Calidad: 320 kbps, 44100 Hz, Joint Stereo MS
Tamaño: 484 Mb


VA - Romantic and Lyrics Vol 2 (2013)
Aqua - Turn Back Time
ATB - We Belong
Beyonce - If I Were A Boy
Black - Wondeful Life
Blackmore’s Night - Ocean Gypsy
Cascada - Everytime We Touch (Yanous Candlelight Mix)
Counting Crows - Colorblind
Craig Armstrong feat. Elizabeth Fraizer - This Love
Dido - Life For Rent
Dido - Thank You
Digital Elvis Zero - Theme From The Ocean
Dubstar - Stars
Duran Duran - Come Undone
Emma Bunton - Life In Mono
F.R. David - Words don’t come easy to me
Gabriel - Lamb
James Blunt - You are beautiful
Jan A.P. Kaczmarek - Goodbye
Jane Birkin Serge Gainsbourg - Je t’aime moi non plus
Jessica Simpson - A Whole New World (Duet with N1)
Johnny Mathis - Feelings
Laid Back - Sunshine Reggae
Laura Fabian - Je T’Aime
Lenny Kravitz - I Belong To You
Mariah Carey - My All
Michael Bolton - A Love So Beautiful
Michael Bolton - All For Love
Mylene Farmer - Appelle Mon Numero
NA
Nino Katamadze - Once in the street
Pandora - Why
Phil Collins - Another Day In Paradise
Pink - I Don’t Believe You
Robert Miles ft. Maria Nayler - One And One
Roberta Flack - Killing Me Softly With His Song
Ronan keating - I believe i can fly
Roxette - A Thing About You
Safri Duo - Adagio
Sandra - I Close My Eyes
Savage Garden - Two Beds And A Coffee Machine
Sinead O’Connor - Nothing Compares To You
Spandau Ballet - I Know This Much Is True
Sting - Fragile
Switchfoot - You
The Bird And The Bee - How Deep Is Your Love
Westlife - My Love
Wham! - Like A Baby
Yasuharu Takanashi - Man of the world ost naruto shippuuden
Youssou N’Dour Neneh Cherry - 7 Seconds