=======================================================
Site: http://www.inspirontrance.com/
=======================================================


=======================================================
F B Page: Inspiron Trance
=======================================================


=======================================================
TWITTER : inspiron22
=======================================================	



Tracklist : 


1. Global Influence - Depth Of My Dreams (Original Mix) [Blue Soho]
2. UDM - Saturation (Ikerya Project Remix) [Silent Shore]
3. FAN FAVORITE: Infite - True Love (New World Remix) [Pulsar]
4. Etasonic - More Than Beautiful (Original Mix) [Beyond the Stars]
5. Matt Chowski - She Was My Everything (Original Mix) [Silver Waves]
6. Lethyx - Indifferent (Original Mix) [Silent Shore White]
7. NIc Toms presents Tom Stronghold - Reflect (Original Mix) [Defcon]
8. BREAKDOWN OF THE WEEK: SoundLift - The Legend (Original Mix) [CDR]
9. Marcel Kenenberg - Discover Universe (Sunset Heat Remix) [Above the Clouds]
10. Robbie Van Doe - Digital Defect (Original Mix) [Nu-Depth]
11. Aeden - Presence (Original Mix) [TFB Records]
12. Allen Watts - Out Of Reach (Original Mix) [Trance All-Stars]
13. Hiroki Nagamine - Saw (Original Mix) [Above the Clouds]
14. Dreamy - This Is It (Jesper Olesen Remix) [Pulsar]
15. Maxima - Proxy (Original Mix) [D.MAX]
16. PRE-RELEASE PICK: SoundGate & Max Solar - Cold Day (Estigma Remix) (Semi-Clean Edit) [Trancendental]
17. E.T Project - Far Away (Original Mix) [Digitized]
18. Kelly Andrew - The Incursion (Original Trance Mix) [Abora]


Enjoy
(Inspiron)