E-book Pakket 1 (epub)NLtoppers


Alastair MacNeill - Broedermoord.epub
Ard Pisa - Het is tijd ben jij klaar voor een nieuwe aarde [Esoterie].pdf
Aster Berkhof - Het huis van Mama Pondo.epub
Bert Muns - [Francien van Anshem 01] Verkeerde vrienden.epub
Danielle Steel - Geen groter liefde.epub
Danielle Steel - Vrijgezellen.epub
Deepak Chopra & Gotham Chopra - Wijsheid op vier poten.epub
Ellen Sussman - Zo is het goed.epub
Ellen van der Heide - Hart vol Liefde [Esoterie].pdf
Ellery Queen - De halve schaar.epub
Herman Heijermans - Kamertjeszonde.epub
Jaap Boekestein - Schaduwstrijd.epub
Jean Sasson - Sultana.epub
Jean-Louis de Biasi - Geheimen, symbolen en rituelen van de Vrijmetselarij.epub
Jeroen van Unen - De Nachtuilen.epub
Karina Bliss - Leven zonder leugens.epub
Kate Mosse - Citadel.epub
Lucas Zandberg - Mayling.epub
Lucas Zandberg - Sisi's Winterlied.epub
Madeleine Albright - Praagse winter.epub
Marc Josten & Rob Smits - Denise de Wit 01 - Opgelicht.epub
Marc Josten & Rob Smits - Denise de Wit 02 - Kroongetuige.epub
Marjan van den Berg - Zeker Sanne.epub
Megan Mulry - [Royal Pain 01] Prinsheerlijk.epub
Michael Robotham - De verdenking.epub
Mofina Rick - [Jack Gannon 01] De wraakengel.epub
Paul van Loon - De Griezelbus 4.epub
Peter Romer - Chantage.epub
Piet Teigeler - [Carpentier & Dewit 01] Een dode op Sint-Anneke.epub
Remco Campert - Somberman's actie.epub
Robert Goddard - Gesloten cirkel.epub
Robyn Young - [De Vier Relieken 01] Opstand.epub
Thea Beckman - Gekaapt.epub
Tomas Ross - Koerier Voor Sarajevo.epub
W.E. Johns - 28 Biggles bij Scotland Yard.epub

Formaat-Epub
Nederlands - Dutch
By Gus_Guzzler