Attention ! Adorateur de la boule à facettes, du rubik's cub et walkman Aiwa, les Faces A et B cette Mixtape en hommages aux stars des 80's sont pour toi, rien que pour toi ! Partage si tu aimes !

FaceA:


Images - Les Démons De Minuit
Bandolero - Paris Latino
François Feldman/Joniece Jamison - Joue Pas
Niagara - L'Amour A La Plage (Club mix)
Ellie Medeiros - Toi mon toit (BMCC Edit).mp3
ThierryHazard - Le Jerk (BMCC Edit)
Gilbert Montagné - Les sunlights des tropiques (BMCC Edit)
Murielle Dacq: Tropique
Jean - Pierre Mader - Macumba
Gold - Capitaine Abandonné (BMCC Edit)
Desireless - Voyage Voyage (Club mix)
Julien Clerc - Quand je joue
Michel Sardou - Les Lac Du Connemara

FaceB:


Début De Soirée - Nuit De Folie
Muriel Dacq - Tropique
Rose Laurens - Africa
Peter & sloane - Besoin de rien, envie de toi
Gold - gold plus près des étoiles (Extended / BMCC edit)
Jean Schulteis - Confidence pour confidence
Chagrin d'amour - Chacun fait (c'qui lui plait)
A Cause Des Garçons - A Cause Des Garçons
Le club - Un fait divers et rien de plus (Extended / BMCC edit)
Rita Mitsouko - Andy ( BMCC Edit)
Philippe Cataldo - Les Divas Du Dancing
Guesh Patti - Etienne (Extended)
Philippe Lafontaine - Coeur De Loup.mp3
Boule Noir - Aimer D'amour

Enjoy et si tu aimes, n'hésite pas à partager ! Merci