Alesso - Clash
Alesso, Matthew Koma - Years (Vocal Extended Mix)
Alvaro - Rock Music
Armin Van Buuren, W&W - D# Fat
Arty - When I See You (Alesso Mix)
Arty feat Chris James - Together We Are (Audien Remix)
Arty ft Chris James - Together We Are
Audien feat Michael S - Leaving You
Avicii - Levels
Avicii vs Nicky Romero - I Could Be The One (John Christian Remix)
Basto - Stormchaser
Bingo Players - Out Of My Mind
Burns - Lies (Otto Knows Remix)
Calvin Harris feat Florence Welch - Sweet Nothing (Extended Mix)
Calvin Harris, Nicky Romero - Iron
Collin Mcloughlin feat Vicetone - Heartbeat
Daddy's Groove - Stellar (Extended Club Mix)
Daddy's Groove, Cryogenix - Vertigo
Daddys Groove - Stellar (A-Lab Remix)
Dario Nunez, Diego Gonzalez feat Luis Izquierdo - Eden (Extendended)
dBerrie - Zenith
Deniz Koyu - Rage
Dimitri Vegas, Like Mike - Wakanda
Dinka feat. James Darcy  - Never Let Go
Dirty South & Deniz Koyu - Halo
Dirty South Alesso feat Ruben Haze - City Of Dreams
Discopolis - Committed To Sparkle Motion (DubVision Remix)
DubVision - Redux
Dzeko & Torres vs. Crossways - Togi
EDX - Blessed (Original Club Mix)
Erick Morillo, Harry Romero, Jose Nunez, Sunnery James, Ryan Marciano - Jungle Blood
Ferry Corsten - Rock Your Body (Dimitri Vegas & Like Mike Mainstage Remix)
Ferry Corsten - Rock Your Body Rock (Arty Rock-N-Rolla Mix)
Gabriel & Dresden feat Molly Bancroft - Tracking Treasure Down Revisited (Dyro Remix)
Gareth Emery - Meet Her In Miami
GTA, Digital Lab ft Henrix - Hit It
Hard Rock Sofa - Rasputin
Hardwell - Spaceman
Hardwell feat Amba Shepherd - Apollo (Dash Berlin 4AM Remix)
Hardwell, Amba Shepherd - Apollo
Hardwell, Showtek - How We Do
Helvetic Nerds - Stormwatch (Chris Reece & Dinka Mix)
Henry Fong, Landis - Get Down
Icona Pop feat Charli XCX - I Love It (Sick Individuals Remix)
Jeremy Olander - Let Me Feel
Jewelz, Scott Sparks - Flashbang
Jochen Miller - Attic
Joe Ghost  - Are You Ready (Hardwell Rework)
John Dish - Karmma
Joonas Hahmo - Reactor
Kaskade, Swanky Tunes feat Lights - No One Knows Who We Are
Keane - Sovereign Light Cafe (Afrojack Remix)
Lana Del Rey - Summertime Sadness (Cedric Gervais Remix)
Lazy Rich - Insomnia
Marc Benjamin - Surrender
Marco V - Walhalla
Mark Knight, Underworld - Ten (Original Club Mix)
Mark Mendes - Prog8
Martin Garrix, Jay Hardway - Error 404
Martin Volt, Quentin State - Fugitive
Mat Zo, Porter Robinson - Easy (Extended Mix)
Matt Caseli, Joel Edwards, Marrs TV - Chemical Love (Sultan & Ned Shepard Remix)
Max Freegrant, Jerome Isma-Ae - Thrill Me
Michael Woods - Platinum Chains
Moguai - Champs
Moguai, Dimitri Vegas & Like Mike - Mammoth
Morgan Page feat Nadia Ali - Carry Me (Extended Mix)
MOTi - Krack
Nicky Romero - Symphonica
Nicky Romero, Avicii - I Could Be the One
Nicky Romero, NERVO - Like Home
Otto Knows - Million Voices
Paris, Simo - Seasons
Passion Pit - Carried Away (Tiesto Remix)
Paul Oakenfold feat Austin Bis - Who Do You Love
Project 46 feat Matthew Steeper - No One
Roul and Doors - Melody In Harmony
Sandro Silva, Quintino - Epic
Sebastian Ingrosso, Tommy Trash - Reload
Showtek, Justin Prime - Cannonball
Sini - Untold
Starkillers & Dmitry KO ft Amba Shepherd - Let The Love
Style of Eye, Tom Staar - After Dark (Club Mix)
Swedish House Mafia - Don't You Worry Child (feat. John Martin) (Extended Mix)
Syn Cole  - April
The Aston Shuffle vs Tommy Trash - Sunrise (Wont Get Lost) (Tommy Trash Version)
The Potbelleez - Saved In A Bottle (Dannic Remix)
Tiesto, Allure - Pair of Dice
Tom Swoon, Amba Shepherd - Not Too Late
Tommy Trash - Monkey See Monkey Do (Tom Staar Remix)
Tony Romera - Pandor
Tritonal feat Underdown - Bullet That Saved Me
Ummet Ozcan - Here & Now
Ummet Ozcan, W&W - The Code
Vinayak A - You May Sit and Wonder (Luke Porter Remix)
Vince Moogin - Love Me Right
W&W - Lift Off
Walden - Intropial (Pierce Fulton Remix)
Wolfpack feat Coco Star - Miracle (Dimitri Vegas & Like Mike Remix)
Zedd feat Foxes - Clarity (Style of Eye Remix)

Bonus Tracks:

2Elements - Tell Me Boy (Tradelove Remix)
Anas Tangi - Ibrido
Praia Del Sol - Maria Lionza (Massivedrum Remix)
Syn & Roc - Vocalicious
TJR - Ode To Oi

