
Old Grey Whistle Test(videoAlbumMusashiSelection):

Tracklist:


Bangles - Walk Like An Egyptian [Video]

BB King - When It All Comes Down & Hold On [Video]
					
Blondie - I'm Allways Touched By Your Presence Dear [Video].mpg	
				
David Bowie - Oh You Pretty Things [Video]

Freddie King - Boogie Funk [Video]

Emmylou Harris - Amarillo [Video]

Focus - Sylvia & Hocus Pocus [Video]

Humble Pie - Black Coffee [Video]					

Dammed - Smash It Up & I Just Can't Be Happy Today [Video].mpg					

Gary Numan - Are Friends Electric [Video].mpg

Humble Pie - Black Coffee [Video]					

Iggy Pop - I'm Bored [Video].mpg

Jam - A Bomb In Wardour Street [Video]					

Japan - Ghosts [Video].mpg					

jesus & Mary Chain - In A Hole [Video]

John Cooper Clarke - I Don't Want To Be Nice [Video]

Johnny Winter - Jumping Jack Flash [Video]

King Crimson - Frame By Frame [Video]

Lone Justice - Sweet Sweet Baby (I'm Falling) [Video]

Lynyrd Skynyrd - Free Bird [Video]

New York Dolls - Jet Boy [Video]

Otway & Barrett - Really Free [Video]					

Police - Can't Stand Loosing You [Video].mpg	
							
REM - Moon River & Pretty Persuasion[Video].

Robin Trower - A Little Bit Of Sympathy [Video]					

Roger Daltrey - Giving It All Away [Video]

Rory Gallagher - Hands Off [Video]

Roxy Music - Do The Strand [Video]

Sade - Is It A Crime [Video]

Sensational Alex Harvey Band - Give My Compliments To the Chef [Video]

Simple Minds - Chelsea Girl [Video]

Simply Red - Holding Back The Years [Video]

Specials - A Message To You Rudi [Video].mpg

Stealers Wheel - I Get By [Video]

Steppenwolf - Born To Be Wild [Video]

Supertramp - Dreamer [Video]					

Talking Heads - Psyco Killer [Video].mpg					

Teardrop Explodes - Reward [Video].mpg	

Tim Buckley - Dolphins [Video]				

Tom Petty & The Heartbreakers -  American Girl [Video].mpg

Tom Waits - Tom Traubert's Blues [Video]					

U2 - I Will Follow [Video].mpg					

Vall Doonican & Charlie McCoy - Stone Fox Chase (The Old Grey Whistle Test Theme) [Video].mpg	
	
Wailers - Stir It Up [Video]
			
XTC - Statue Of Liberty [Video].mpg					




//////////////////////////////////////////////////////////

