Track List

Part 1 - Deep House:

Azure Ray - Larraine (MATZINGHA edit)

Sade ΓÇô No Ordinary Love (Millok Private Remake)

Aleah - Breath (Matt Lennox Grey Days Edit)

Nebu Mitte Ft. Jaselle - With You (Yves Murasca vs. Nebu Re-Twist)

Martin Brodin - Vicious Games (Original Mix)

Funky Green Dogs - Fired Up! (Hot Since 82 Remix)

Ferry Ultra Ft. Ashley Slater - Why Did You Do It (Larse Remix)

Joe Cocker - You Can Leave Your Hat On (Al K Acoustic Cover)

Peer Kusiv - Someone Told Me 

Lana Del Rey - Summertime Sadness (Asadinho Main Vocal Mix)

Pink Floyd - Another Brick In The Wall (Vintage Culture Remix)

Tom Odell - Another Love (David B. Edit)

Rainer Weichhold - Jalapeno

Ntfo feat. forrest - Changin (original mix) 

DOS - Chance To Desire (Extended Mix) 

New Order - Blue Monday (Lewis Lastella Remix)

J Paul Getto - Different Folks (Original Mix)

Mono ΓÇô Glass of Heart (Original Mix)

Agent Greg, DSF - Break The Ice (Original Mix)



Part 2 - Minimal Techno ,Electro House:

Tip DOris - Loss Of The Soul (Original Mix)

LOUISAHHH!!! - Tap My Wire (Original Mix)

Stiv & Vallo - Just Awake (Piatto Remix)

Koen Groeneveld - Game Of Luv (Original Mix)

Klubbingman - Love Message (South Blast! 2013 Re-Work)

Dj Chuckie amp Hardwell feat Ambush - Move it 2 The Drum (Original Mix)

Maguta - Terrorist (Original Mix)

Dero - Mystify (Dero In Excess Mix) 

Kid Kenobi feat. Big Nab - Freak Funk (Kid Kenobi VIP Remix)

Teddy Cream - Im FUKD (Extended Mix)

Pulsedriver - Kiss That Sound 2.0 (club mix)

Funkastarz & D-Jastic - Krak (Club Mix)

Havoc (AUS), Ish Kariuki & Treyy G - Lay It Down (Original Mix)

Lula Stefano - Noferini (Remix)

Droplex - Narkotik (Original Mix)

Dani San, Daniel Gorziza - Green Juice (Dani San  Remix)
