Banta-Cain - Out Of Control (Ft. Joe Budden, Slaine & Millyz).mp3
Bow Wow - Grown Ass Man.mp3
Chevy Woods - Pour It Up (Remix).mp3
Chris Brown - Let The Blunt Go (Ft. Problem) (Official Version).mp3
Compton Menace - Aint Goin For It (Ft. Ya Boy).mp3
Consequence - Back Down To Earth.mp3
DJ Self - New York Times (Ft. Jim Jones).mp3
Freddie Gibbs, Devin The Dude, Killa Kyleon, Starlito & Propain - Rollin.mp3
Ghostface Killah & Adrian Younge - The Sure Shot (Pt. 1 & 2 ).mp3
JAE E - Big Time (Ft. Young Dro).mp3
Jasiri X - The Pillars (Ft. Brother Ali).mp3
Kid Tsunami - The Chase (Ft. Buckshot, Chubb Rock, Pharoahe Monch & Jeru The Damaja).mp3
M3 - I Be (Ft. Kid Daytona).mp3
Mayalino - Cadillac (Ft. Bun B & Mannie Fresh).mp3
Papoose - Major Distribution (Freestyle).mp3
Papoose - Whats My Name (Ft. Remy Ma).mp3
Para One - Every Little Thing (Remix) (Ft. Cam'ron, Irfane & Tekilatex).mp3
Pill - Everybody Lookin.mp3
Roosh Williams - Bet's On Me (Ft. Scarface & CG).mp3
Sir Michael Rocks - Money Came.mp3
SpaceGhostPurrp - Alize Music.mp3
SpaceGhostPurrp - Throwed.mp3
Terrace Martin - Poetic Justice (Saxophone Remix).mp3
The Kid Daytona & DJ Ozone - No Reason.mp3
The Midi Mafia - The Vibe Pt. 2 (Ft. Mann & Honey Cocaine).mp3
Tony Jones  - Diamonds In My Chain (Ft. Slim Thug).mp3
Travi$ Scott - Pussy (Ft. Gunplay, Chuck Inglish & Fredo Santana).mp3
UZ - Trap Shit V3 (I Got This) (Ft. Trae Tha Truth, Problem & Trinidad James).mp3
Waka Flocka & Wooh Da Kid-Seen Alot.mp3


follow at noles506 , @newtracksdaily , fbook @thachronicizback