PART 1 : Sharam ft. Daniel Bedingfield ΓÇô The One (Downtempo Mix)

Dead Can Dance - The Host Of Seraphim (ENiGMA Dubz Mix!)

despina vandi   gia ( nhertz dubstep remix )

Yung Joc - Goin Down (Milo & Otis Unoriginal Mix)

Yellow Claw - Kaolo

Dillon Francis - Masta Blasta (THE REBIRTH)

Biatlone - Together (Anturage & Amnesia Haze Remix)

Forrest Forrest

Nym - Et Moi

Stefan Biniak - The Read All About It (Stefan Biniak Edit)

Anthony Hamilton & Elayna Boynton - Freedom (Julius Abel Remix)

Valeron - I Love You So Much (Original)

Kai Wachi & Squnto - Brain Splat (Original Mix)

eSenTRiK - Collapse

Hucci - House Party (feat. Meek Mill)

adele - skyfall (sammie trap remix) 



PART 2: Dawork - Follow My Rules (Rachel Vocal Mix)

Simone Torosani - I House You (Haran Banjo Remix)

Will Sparks feat Flea - Chemical Energy (Original Mix Starkiller sOfficial)

Hot Shit! - Check This Out (Loutaa Remix)

Beats Sounds - Love Minimal (original mix) 

Yan Oxygen - System Off (Original Mix)

DJ Navigare - Ai - Ai (Original Mix) 

Josue Carrera - SOTL

Maxx King vs. Stee Wee Bee ΓÇô Tomorrow (Gordon & Doyle Remix)

Jim Noize - Rock & Move (Ron Collins Remix)

Kris, Ivo Nikolov, Donna - The Sunset Flower (D-Trax & Wallie Remix)

Eddy T - On My Way (Matteo Marini Remix)

Ortega, Itay Kalderon, Maya Simantov - Why Me (Original Mix) 

The Bloody Beetroots, MOTI, Greta Svabo Bech - Chronicles Of A Fallen Love (MOTi Remix) 

Oldschool Boys - Saturday Night (Club Mix)

Mike Candys - Together Again feat. Evelyn (2013 Rework)

Murray Head - One Night In Bangkok (DJ Oleg Perets Remix)

Christina Aguilera - Your Body (Fernandez Remix)