
Director	Pedro Almodóvar
Guión	Pedro Almodóvar
Productores	Agustín Almodóvar y Esther García
Música	Alberto Iglesias
Montaje	José Salcedo
Director de fotografía	José Luis Alcaine
Director artístico	Antxon Gómez
Productores asociados	Bárbara Peiró y Diego Pajuelo
Director de producción	Toni Novella
Sonido directo	Iván Marín
Editor de sonido	Pelayo Gutiérrez
Mezclas	Marc Orts
Maquillaje	Ana Lozano
Peluquería	Sergio Pérez Berbel
Vestuario	Tatiana Hernández, con la colaboración de Davidelfín
Coreografía	Blanca Li

[b]Sinopsis[/b]


Un grupo de personajes variopintos viven una situación de riesgo dentro de un avión que se dirige a México D.F.

La indefensión ante el peligro provoca una catarsis generalizada que acaba convirtiéndose en el mejor modo de escapar a la idea de la muerte. Esta catarsis, desarrollada en tono
     de comedia desaforada y moral, llena el tiempo de confesiones imprevisibles que les ayudan a olvidar la angustia del momento y a enfrentarse al mayor de los
                                                       peligros, el que cada uno lleva dentro de sí mismo.
[b]Ficha artística[/b]


Por orden de aparición
Antonio Banderas	León
Penélope Cruz	Jessica
Cote Soler	Operario 2
Antonio de la Torre	Álex Acero
Hugo Silva	Benito Morón
Miguel Ángel Silvestre	Novio
Laya Martí	Novia
Javier Cámara	Joserra
Carlos Areces	Fajas...


