Hello guys. 

I'll present myself as xGR dub :)

Now,i will upload dubstep torrents to PirateBay,as often as i can,but i discover new songs every day :) this is my first torrent made.

AND THE BEST FUCKING THING,NO SKRILLEXY SHIT! ONLY THE HARDEST! THAT'S ALL I LISTEN,AND MANY PEOPLE DO,SO IM DOING THAT LIKE PEOPLE A FAVOUR AND DO AN ONLY HARDEST TORRENT,SO THEY DON'T NEED TO DOWNLOAD 2 GB COMPILATIONS OF 98 SHITTY SONGS AND 2 FAIR SONGS. :D


==========================================================================

PLAYLIST:
Antiserum - The Swarm

Bare Noize - Plant Food

Blackburner - Easter Death Bunny

Bong - Fallen Angel VIP

Datsik - Mechano (Culprate Remix)

DGKiefer - Dance With The Devil

DOCTOR P - NEON [MORTAR REMIX]

Document One - New Danger

Genetix - Here Comes The Drastik Final

Genetix - Squid Attack

Liquid Stranger - Nuclear Bomb(DubStep)

Muffler - Machines

p0gman - Smoke Machine

Quartus Saul - Hagakure (Original Mix)

Ry Legit - Ultraviolence

Secret Lemon Project - Get Mad 

Skanek - Soul

Skrubz - Fuck You Bitch

Structured Noises - Darkstep Warrior

Substar & Frenk Dublin - Toxicated

Subvibe - Damage

SubVibe - Ominous

T.O.B - Decoy (Mark Instinct Remix)

Tomba - Symphony No. 666  ┬½Juicy DuB

Trampa - Daleks 2011 VIP

Transplant (SludgeStep Mix) -Filthy Dubstep- - DOPE!

Tunnidge - 7 Breaths

Urban Assault - Halloween (Original Mix)

Varien - Throne of Ravens

WonKy - DonKy

=*=*=*=*=*=*=*=*==*=*==*=*=*=*=*=*=*=*=*=*=*=*=*=*=*=*=*=*==*=*=*=*=*=*=*=




All songs are in mp3 format.


AND PLEASE,SEED AFTER DOWNLOAD,I AM NOT THE ONLY USER OF MY NETWORK,I WILL SEED FEW DAYS,BUT PLEASE,SOMEONE TAKE OVER WHEN YOU DOWNLOAD. I HAVE NEW COMPILATIONS TO MAKE :D


