Alpac - Coke Talk (Ft. Styles P & French Montana).mp3
AZ - Thank You (Freestyle).mp3
Belly - Money Makes The World Go Round (Ft. French Montana & Chinx Drugz).mp3
Berner - Me & You.mp3
Birdman - Tapout (Ft. Lil Wayne, Future, Nicki Minaj & Future).mp3
Black Milk ΓÇô Sundays Best - Mondays Worst.mp3
Ca$h Out - Who Gives A Phuck (Ft. Rocko).mp3
Cap 1 - Loc'n (Ft. Nipsey Hussle).mp3
Chinx Drugz - Right There (Ft. French Montana & Juicy J).mp3
Danny Brown - Kush Coma.mp3
Eric Benet - News For You (Ft. 2 Chainz).mp3
Fat Joe - Ballin (Ft. Wiz Khalifa & Teyana Taylor).mp3
Fiend - Just Groovin (Ft. Devin The Dude).mp3
Fiend - No Apologies (Ft. Styles P).mp3
Future - Usual.mp3
Honey Cocaine - Middle Finger.mp3
Illsmith (Kardinal Offishal & Double Time) - Wilin.mp3
JFK & Statik Selektah - Get Lost (R.I.P. Guru) (Ft. Wais P & Cheeck Lamotta).mp3
Kidz In The Hall - No Doz .mp3
King Chip - Under Palm Trees.mp3
Krayzie Bone - A Good Look.mp3
Lil Wayne - Rich As Fuck (Ft. 2 Chainz).mp3
LL Cool J - We Came To Party (Ft. Snoop Dogg & Fatman Scoop).mp3
Lupe Fiasco - Jonylah Forever.mp3
Maino - Gangsta (Remix).mp3
Marco Polo - Nite & Day (Ft. Big Daddy Kane).mp3
Marvo - This Aint New To Me (Ft. Future).mp3
Prince Malik - I Wanna Know (Ft. DJ Khaled, Ace Hood & Jim Jones).mp3
Project Pat - Weed Smoke (Remix) (Ft. Mac Miller).mp3
R.F.C. (Smoke DZA, NYMLo & Al-Doe) - Decisions.mp3
R.F.C. (Smoke DZA, NYMLo & Al-Doe) - Shadows.mp3
Raekwon - 86 (Remix) (Ft. AZ & Altrina Renee).mp3
Square Off - 110th Street (Ft. Killa Kyleon).mp3
Swollen Members - Death To You (Ft. Ill Bill, Slaine & Vinnie Paz).mp3
Tank - Shots Fired (Ft. Chris Brown).mp3
Tech N9ne - B.I.T.C.H. (Ft. T-Pain).mp3
Termanology - Bars For Days (Ft. Nitty Scott, MC & Ea$y Money).mp3
Tsu Surf - Broken Dreams (Ft. Ab-Soul & Fred The Godson).mp3
Wyld - Street Propaganda (Ft. Clipse).mp3
Yelawolf - Rhyme Room (Ft. Raekwon & Killer Mike).mp3
Young Dro - F.D.B. (Fuck Dat Bitch).mp3