Maxi Singles Of The 90's (Part 2)


2 Pac - California Love
2 Unlimited - The Magic Friend
2 Unlimited - Tribal Dance
20 Fingers Feat. Gilette - Short Dick Man
20 Fingers Feat. Roula- Lick It
Ace Of Base - The Sign
Ace Of Base - Wheel Of Fortune
Adamski - Killer
Alcazar - Crying At The Discoteque
Alex Party - Don't Give Me Your Life
Ann Lee - 2 Times
Aqua - Barbie Girl
Armand Van Helden feat Duane Harden - You Dont Know Me
ATB - 9 PM (Till I Come)
Bass Bumpers - The Music's Got Me
BC-52's - Love Shak
Black Box feat. Loleatta Holloway - Ride On Time
Bomfunk MCs - Freestyler
Brandy & Monica - The Boy Is Mine
C+C Music Factory - Things That Make You Go Hmmmm
Capella - U Got 2 Let The Music
Carolina Marquez - Sexo sexo
Ce Ce Peniston - Finally
Corona - Baby Baby
Crystal Waters - Gypsy Woman (She's Homeless)
Dj Bobo - Everybody
DJ Bobo - Somebody Dance With Me
DJ Tonka - She Knows You
DNA & Suzanne Vega - Tom's Diner
Eiffel 65 - Blue (Da Ba Dee)
Everything But The Girl - Missing
Faithless - Insomnia
Gala - Come Into My Life
Gala - Freed From Desire
Garcia - Vamonos (Hey Chico Are You Ready)
Gigi Dagostino - Bla Bla Bla
Gina G - Ooh Aah... Just A Little Bit
Gina G - Ti Amo
JT And The Big Family - I Kick You In A Ditch
Kylie Minogue - Confide In Me
Lisa Stansfield - Change
London Beat - I've Been Thinking About You
Loona - Bailando
Lou Bega - Mambo No. 5
Madison Avenue - Don't Call Me Baby
Madonna - Express Yourself
Madonna - Material Girl
Magic Affair - Give Me All Your Love (Omen-The Story Continues)
MC Hammer - U Can't Touch This
Michael Jackson - Who Is It
Moloko - Sing It Back
Nana - Lonely
Olive - You're Not Alone
Paul Johnson - Get Get Down
Rednex - Cotton Eye Joe
Robert Miles - Children
Robrt Miles - Fable
Run DMC vs Jason Nevins - It's Like That
Sash - Encore Une Fois
Shakespears Sister - You're History
Snap! - Do You See The Light
Snap! - Exterminate
Stardust - Music Sounds Better With You
The Prodigy - No Good (Start The Dance)
The Shamen - Love Sex Intelligence
Todd Terry feat. Martha Wash amd Jocelyn Brown - Something's Goin' On
Tom Novy - Now Or Never
UB40 - (I Can't Help) Falling In Love With You
Ultra Nate - Free
Vengaboys - Up & Down
Wamdue Project - King Of My Castle
Whigfield - Saturday Night
Yazoo - Don't Go
